id,scan_t1ce,scan_t2,scan_flair,scan_t1,label,center_x,center_y,center_z,x_extreme_min,x_extreme_max,y_extreme_min,y_extreme_max,z_extreme_min,z_extreme_max,x_size,y_size,z_size
02902-100,../../DataSet/BraTS2024-BraTS-GLI-TrainingData/BraTS-GLI-02902-100/BraTS-GLI-02902-100-t1c.nii.gz,../../DataSet/BraTS2024-BraTS-GLI-TrainingData/BraTS-GLI-02902-100/BraTS-GLI-02902-100-t2w.nii.gz,../../DataSet/BraTS2024-BraTS-GLI-TrainingData/BraTS-GLI-02902-100/BraTS-GLI-02902-100-t2f.nii.gz,../../DataSet/BraTS2024-BraTS-GLI-TrainingData/BraTS-GLI-02902-100/BraTS-GLI-02902-100-t1n.nii.gz,../../DataSet/BraTS2024-BraTS-GLI-TrainingData/BraTS-GLI-02902-100/BraTS-GLI-02902-100-seg.nii.gz,127,116,114,107,152,88,147,92,145,45,59,53
02093-101,../../DataSet/BraTS2024-BraTS-GLI-TrainingData/BraTS-GLI-02093-101/BraTS-GLI-02093-101-t1c.nii.gz,../../DataSet/BraTS2024-BraTS-GLI-TrainingData/BraTS-GLI-02093-101/BraTS-GLI-02093-101-t2w.nii.gz,../../DataSet/BraTS2024-BraTS-GLI-TrainingData/BraTS-GLI-02093-101/BraTS-GLI-02093-101-t2f.nii.gz,../../DataSet/BraTS2024-BraTS-GLI-TrainingData/BraTS-GLI-02093-101/BraTS-GLI-02093-101-t1n.nii.gz,../../DataSet/BraTS2024-BraTS-GLI-TrainingData/BraTS-GLI-02093-101/BraTS-GLI-02093-101-seg.nii.gz,109,171,95,70,137,118,202,50,142,67,84,92
02111-100,../../DataSet/BraTS2024-BraTS-GLI-TrainingData/BraTS-GLI-02111-100/BraTS-GLI-02111-100-t1c.nii.gz,../../DataSet/BraTS2024-BraTS-GLI-TrainingData/BraTS-GLI-02111-100/BraTS-GLI-02111-100-t2w.nii.gz,../../DataSet/BraTS2024-BraTS-GLI-TrainingData/BraTS-GLI-02111-100/BraTS-GLI-02111-100-t2f.nii.gz,../../DataSet/BraTS2024-BraTS-GLI-TrainingData/BraTS-GLI-02111-100/BraTS-GLI-02111-100-t1n.nii.gz,../../DataSet/BraTS2024-BraTS-GLI-TrainingData/BraTS-GLI-02111-100/BraTS-GLI-02111-100-seg.nii.gz,77,77,109,57,94,52,101,80,143,37,49,63
02851-101,../../DataSet/BraTS2024-BraTS-GLI-TrainingData/BraTS-GLI-02851-101/BraTS-GLI-02851-101-t1c.nii.gz,../../DataSet/BraTS2024-BraTS-GLI-TrainingData/BraTS-GLI-02851-101/BraTS-GLI-02851-101-t2w.nii.gz,../../DataSet/BraTS2024-BraTS-GLI-TrainingData/BraTS-GLI-02851-101/BraTS-GLI-02851-101-t2f.nii.gz,../../DataSet/BraTS2024-BraTS-GLI-TrainingData/BraTS-GLI-02851-101/BraTS-GLI-02851-101-t1n.nii.gz,../../DataSet/BraTS2024-BraTS-GLI-TrainingData/BraTS-GLI-02851-101/BraTS-GLI-02851-101-seg.nii.gz,81,72,129,66,114,52,95,92,154,48,43,62
02206-100,../../DataSet/BraTS2024-BraTS-GLI-TrainingData/BraTS-GLI-02206-100/BraTS-GLI-02206-100-t1c.nii.gz,../../DataSet/BraTS2024-BraTS-GLI-TrainingData/BraTS-GLI-02206-100/BraTS-GLI-02206-100-t2w.nii.gz,../../DataSet/BraTS2024-BraTS-GLI-TrainingData/BraTS-GLI-02206-100/BraTS-GLI-02206-100-t2f.nii.gz,../../DataSet/BraTS2024-BraTS-GLI-TrainingData/BraTS-GLI-02206-100/BraTS-GLI-02206-100-t1n.nii.gz,../../DataSet/BraTS2024-BraTS-GLI-TrainingData/BraTS-GLI-02206-100/BraTS-GLI-02206-100-seg.nii.gz,72,81,90,50,100,49,119,41,126,50,70,85
00553-100,../../DataSet/BraTS2024-BraTS-GLI-TrainingData/BraTS-GLI-00553-100/BraTS-GLI-00553-100-t1c.nii.gz,../../DataSet/BraTS2024-BraTS-GLI-TrainingData/BraTS-GLI-00553-100/BraTS-GLI-00553-100-t2w.nii.gz,../../DataSet/BraTS2024-BraTS-GLI-TrainingData/BraTS-GLI-00553-100/BraTS-GLI-00553-100-t2f.nii.gz,../../DataSet/BraTS2024-BraTS-GLI-TrainingData/BraTS-GLI-00553-100/BraTS-GLI-00553-100-t1n.nii.gz,../../DataSet/BraTS2024-BraTS-GLI-TrainingData/BraTS-GLI-00553-100/BraTS-GLI-00553-100-seg.nii.gz,51,113,71,30,85,51,147,45,126,55,96,81
02748-101,../../DataSet/BraTS2024-BraTS-GLI-TrainingData/BraTS-GLI-02748-101/BraTS-GLI-02748-101-t1c.nii.gz,../../DataSet/BraTS2024-BraTS-GLI-TrainingData/BraTS-GLI-02748-101/BraTS-GLI-02748-101-t2w.nii.gz,../../DataSet/BraTS2024-BraTS-GLI-TrainingData/BraTS-GLI-02748-101/BraTS-GLI-02748-101-t2f.nii.gz,../../DataSet/BraTS2024-BraTS-GLI-TrainingData/BraTS-GLI-02748-101/BraTS-GLI-02748-101-t1n.nii.gz,../../DataSet/BraTS2024-BraTS-GLI-TrainingData/BraTS-GLI-02748-101/BraTS-GLI-02748-101-seg.nii.gz,121,130,91,102,140,80,174,62,122,38,94,60
02799-101,../../DataSet/BraTS2024-BraTS-GLI-TrainingData/BraTS-GLI-02799-101/BraTS-GLI-02799-101-t1c.nii.gz,../../DataSet/BraTS2024-BraTS-GLI-TrainingData/BraTS-GLI-02799-101/BraTS-GLI-02799-101-t2w.nii.gz,../../DataSet/BraTS2024-BraTS-GLI-TrainingData/BraTS-GLI-02799-101/BraTS-GLI-02799-101-t2f.nii.gz,../../DataSet/BraTS2024-BraTS-GLI-TrainingData/BraTS-GLI-02799-101/BraTS-GLI-02799-101-t1n.nii.gz,../../DataSet/BraTS2024-BraTS-GLI-TrainingData/BraTS-GLI-02799-101/BraTS-GLI-02799-101-seg.nii.gz,130,108,71,101,157,63,143,51,96,56,80,45
02623-102,../../DataSet/BraTS2024-BraTS-GLI-TrainingData/BraTS-GLI-02623-102/BraTS-GLI-02623-102-t1c.nii.gz,../../DataSet/BraTS2024-BraTS-GLI-TrainingData/BraTS-GLI-02623-102/BraTS-GLI-02623-102-t2w.nii.gz,../../DataSet/BraTS2024-BraTS-GLI-TrainingData/BraTS-GLI-02623-102/BraTS-GLI-02623-102-t2f.nii.gz,../../DataSet/BraTS2024-BraTS-GLI-TrainingData/BraTS-GLI-02623-102/BraTS-GLI-02623-102-t1n.nii.gz,../../DataSet/BraTS2024-BraTS-GLI-TrainingData/BraTS-GLI-02623-102/BraTS-GLI-02623-102-seg.nii.gz,86,83,107,66,90,55,110,55,126,24,55,71
02166-101,../../DataSet/BraTS2024-BraTS-GLI-TrainingData/BraTS-GLI-02166-101/BraTS-GLI-02166-101-t1c.nii.gz,../../DataSet/BraTS2024-BraTS-GLI-TrainingData/BraTS-GLI-02166-101/BraTS-GLI-02166-101-t2w.nii.gz,../../DataSet/BraTS2024-BraTS-GLI-TrainingData/BraTS-GLI-02166-101/BraTS-GLI-02166-101-t2f.nii.gz,../../DataSet/BraTS2024-BraTS-GLI-TrainingData/BraTS-GLI-02166-101/BraTS-GLI-02166-101-t1n.nii.gz,../../DataSet/BraTS2024-BraTS-GLI-TrainingData/BraTS-GLI-02166-101/BraTS-GLI-02166-101-seg.nii.gz,110,58,89,90,137,34,95,65,121,47,61,56
02610-101,../../DataSet/BraTS2024-BraTS-GLI-TrainingData/BraTS-GLI-02610-101/BraTS-GLI-02610-101-t1c.nii.gz,../../DataSet/BraTS2024-BraTS-GLI-TrainingData/BraTS-GLI-02610-101/BraTS-GLI-02610-101-t2w.nii.gz,../../DataSet/BraTS2024-BraTS-GLI-TrainingData/BraTS-GLI-02610-101/BraTS-GLI-02610-101-t2f.nii.gz,../../DataSet/BraTS2024-BraTS-GLI-TrainingData/BraTS-GLI-02610-101/BraTS-GLI-02610-101-t1n.nii.gz,../../DataSet/BraTS2024-BraTS-GLI-TrainingData/BraTS-GLI-02610-101/BraTS-GLI-02610-101-seg.nii.gz,120,97,92,75,151,46,142,48,129,76,96,81
02199-104,../../DataSet/BraTS2024-BraTS-GLI-TrainingData/BraTS-GLI-02199-104/BraTS-GLI-02199-104-t1c.nii.gz,../../DataSet/BraTS2024-BraTS-GLI-TrainingData/BraTS-GLI-02199-104/BraTS-GLI-02199-104-t2w.nii.gz,../../DataSet/BraTS2024-BraTS-GLI-TrainingData/BraTS-GLI-02199-104/BraTS-GLI-02199-104-t2f.nii.gz,../../DataSet/BraTS2024-BraTS-GLI-TrainingData/BraTS-GLI-02199-104/BraTS-GLI-02199-104-t1n.nii.gz,../../DataSet/BraTS2024-BraTS-GLI-TrainingData/BraTS-GLI-02199-104/BraTS-GLI-02199-104-seg.nii.gz,104,161,99,72,125,106,184,68,135,53,78,67
02152-102,../../DataSet/BraTS2024-BraTS-GLI-TrainingData/BraTS-GLI-02152-102/BraTS-GLI-02152-102-t1c.nii.gz,../../DataSet/BraTS2024-BraTS-GLI-TrainingData/BraTS-GLI-02152-102/BraTS-GLI-02152-102-t2w.nii.gz,../../DataSet/BraTS2024-BraTS-GLI-TrainingData/BraTS-GLI-02152-102/BraTS-GLI-02152-102-t2f.nii.gz,../../DataSet/BraTS2024-BraTS-GLI-TrainingData/BraTS-GLI-02152-102/BraTS-GLI-02152-102-t1n.nii.gz,../../DataSet/BraTS2024-BraTS-GLI-TrainingData/BraTS-GLI-02152-102/BraTS-GLI-02152-102-seg.nii.gz,59,73,86,40,85,47,107,65,115,45,60,50
02245-102,../../DataSet/BraTS2024-BraTS-GLI-TrainingData/BraTS-GLI-02245-102/BraTS-GLI-02245-102-t1c.nii.gz,../../DataSet/BraTS2024-BraTS-GLI-TrainingData/BraTS-GLI-02245-102/BraTS-GLI-02245-102-t2w.nii.gz,../../DataSet/BraTS2024-BraTS-GLI-TrainingData/BraTS-GLI-02245-102/BraTS-GLI-02245-102-t2f.nii.gz,../../DataSet/BraTS2024-BraTS-GLI-TrainingData/BraTS-GLI-02245-102/BraTS-GLI-02245-102-t1n.nii.gz,../../DataSet/BraTS2024-BraTS-GLI-TrainingData/BraTS-GLI-02245-102/BraTS-GLI-02245-102-seg.nii.gz,75,125,121,37,108,80,171,84,154,71,91,70
02821-100,../../DataSet/BraTS2024-BraTS-GLI-TrainingData/BraTS-GLI-02821-100/BraTS-GLI-02821-100-t1c.nii.gz,../../DataSet/BraTS2024-BraTS-GLI-TrainingData/BraTS-GLI-02821-100/BraTS-GLI-02821-100-t2w.nii.gz,../../DataSet/BraTS2024-BraTS-GLI-TrainingData/BraTS-GLI-02821-100/BraTS-GLI-02821-100-t2f.nii.gz,../../DataSet/BraTS2024-BraTS-GLI-TrainingData/BraTS-GLI-02821-100/BraTS-GLI-02821-100-t1n.nii.gz,../../DataSet/BraTS2024-BraTS-GLI-TrainingData/BraTS-GLI-02821-100/BraTS-GLI-02821-100-seg.nii.gz,121,62,96,100,148,28,98,65,132,48,70,67
02795-100,../../DataSet/BraTS2024-BraTS-GLI-TrainingData/BraTS-GLI-02795-100/BraTS-GLI-02795-100-t1c.nii.gz,../../DataSet/BraTS2024-BraTS-GLI-TrainingData/BraTS-GLI-02795-100/BraTS-GLI-02795-100-t2w.nii.gz,../../DataSet/BraTS2024-BraTS-GLI-TrainingData/BraTS-GLI-02795-100/BraTS-GLI-02795-100-t2f.nii.gz,../../DataSet/BraTS2024-BraTS-GLI-TrainingData/BraTS-GLI-02795-100/BraTS-GLI-02795-100-t1n.nii.gz,../../DataSet/BraTS2024-BraTS-GLI-TrainingData/BraTS-GLI-02795-100/BraTS-GLI-02795-100-seg.nii.gz,72,58,113,45,96,18,103,76,144,51,85,68
02905-100,../../DataSet/BraTS2024-BraTS-GLI-TrainingData/BraTS-GLI-02905-100/BraTS-GLI-02905-100-t1c.nii.gz,../../DataSet/BraTS2024-BraTS-GLI-TrainingData/BraTS-GLI-02905-100/BraTS-GLI-02905-100-t2w.nii.gz,../../DataSet/BraTS2024-BraTS-GLI-TrainingData/BraTS-GLI-02905-100/BraTS-GLI-02905-100-t2f.nii.gz,../../DataSet/BraTS2024-BraTS-GLI-TrainingData/BraTS-GLI-02905-100/BraTS-GLI-02905-100-t1n.nii.gz,../../DataSet/BraTS2024-BraTS-GLI-TrainingData/BraTS-GLI-02905-100/BraTS-GLI-02905-100-seg.nii.gz,126,142,96,96,149,105,170,68,132,53,65,64
02887-101,../../DataSet/BraTS2024-BraTS-GLI-TrainingData/BraTS-GLI-02887-101/BraTS-GLI-02887-101-t1c.nii.gz,../../DataSet/BraTS2024-BraTS-GLI-TrainingData/BraTS-GLI-02887-101/BraTS-GLI-02887-101-t2w.nii.gz,../../DataSet/BraTS2024-BraTS-GLI-TrainingData/BraTS-GLI-02887-101/BraTS-GLI-02887-101-t2f.nii.gz,../../DataSet/BraTS2024-BraTS-GLI-TrainingData/BraTS-GLI-02887-101/BraTS-GLI-02887-101-t1n.nii.gz,../../DataSet/BraTS2024-BraTS-GLI-TrainingData/BraTS-GLI-02887-101/BraTS-GLI-02887-101-seg.nii.gz,46,62,70,31,67,39,94,60,86,36,55,26
02116-100,../../DataSet/BraTS2024-BraTS-GLI-TrainingData/BraTS-GLI-02116-100/BraTS-GLI-02116-100-t1c.nii.gz,../../DataSet/BraTS2024-BraTS-GLI-TrainingData/BraTS-GLI-02116-100/BraTS-GLI-02116-100-t2w.nii.gz,../../DataSet/BraTS2024-BraTS-GLI-TrainingData/BraTS-GLI-02116-100/BraTS-GLI-02116-100-t2f.nii.gz,../../DataSet/BraTS2024-BraTS-GLI-TrainingData/BraTS-GLI-02116-100/BraTS-GLI-02116-100-t1n.nii.gz,../../DataSet/BraTS2024-BraTS-GLI-TrainingData/BraTS-GLI-02116-100/BraTS-GLI-02116-100-seg.nii.gz,52,114,104,24,84,69,163,69,148,60,94,79
03020-100,../../DataSet/BraTS2024-BraTS-GLI-TrainingData/BraTS-GLI-03020-100/BraTS-GLI-03020-100-t1c.nii.gz,../../DataSet/BraTS2024-BraTS-GLI-TrainingData/BraTS-GLI-03020-100/BraTS-GLI-03020-100-t2w.nii.gz,../../DataSet/BraTS2024-BraTS-GLI-TrainingData/BraTS-GLI-03020-100/BraTS-GLI-03020-100-t2f.nii.gz,../../DataSet/BraTS2024-BraTS-GLI-TrainingData/BraTS-GLI-03020-100/BraTS-GLI-03020-100-t1n.nii.gz,../../DataSet/BraTS2024-BraTS-GLI-TrainingData/BraTS-GLI-03020-100/BraTS-GLI-03020-100-seg.nii.gz,55,93,101,30,83,54,131,71,128,53,77,57
02239-102,../../DataSet/BraTS2024-BraTS-GLI-TrainingData/BraTS-GLI-02239-102/BraTS-GLI-02239-102-t1c.nii.gz,../../DataSet/BraTS2024-BraTS-GLI-TrainingData/BraTS-GLI-02239-102/BraTS-GLI-02239-102-t2w.nii.gz,../../DataSet/BraTS2024-BraTS-GLI-TrainingData/BraTS-GLI-02239-102/BraTS-GLI-02239-102-t2f.nii.gz,../../DataSet/BraTS2024-BraTS-GLI-TrainingData/BraTS-GLI-02239-102/BraTS-GLI-02239-102-t1n.nii.gz,../../DataSet/BraTS2024-BraTS-GLI-TrainingData/BraTS-GLI-02239-102/BraTS-GLI-02239-102-seg.nii.gz,53,126,53,33,77,107,148,40,72,44,41,32
02856-101,../../DataSet/BraTS2024-BraTS-GLI-TrainingData/BraTS-GLI-02856-101/BraTS-GLI-02856-101-t1c.nii.gz,../../DataSet/BraTS2024-BraTS-GLI-TrainingData/BraTS-GLI-02856-101/BraTS-GLI-02856-101-t2w.nii.gz,../../DataSet/BraTS2024-BraTS-GLI-TrainingData/BraTS-GLI-02856-101/BraTS-GLI-02856-101-t2f.nii.gz,../../DataSet/BraTS2024-BraTS-GLI-TrainingData/BraTS-GLI-02856-101/BraTS-GLI-02856-101-t1n.nii.gz,../../DataSet/BraTS2024-BraTS-GLI-TrainingData/BraTS-GLI-02856-101/BraTS-GLI-02856-101-seg.nii.gz,131,101,97,108,154,76,132,83,112,46,56,29
02977-100,../../DataSet/BraTS2024-BraTS-GLI-TrainingData/BraTS-GLI-02977-100/BraTS-GLI-02977-100-t1c.nii.gz,../../DataSet/BraTS2024-BraTS-GLI-TrainingData/BraTS-GLI-02977-100/BraTS-GLI-02977-100-t2w.nii.gz,../../DataSet/BraTS2024-BraTS-GLI-TrainingData/BraTS-GLI-02977-100/BraTS-GLI-02977-100-t2f.nii.gz,../../DataSet/BraTS2024-BraTS-GLI-TrainingData/BraTS-GLI-02977-100/BraTS-GLI-02977-100-t1n.nii.gz,../../DataSet/BraTS2024-BraTS-GLI-TrainingData/BraTS-GLI-02977-100/BraTS-GLI-02977-100-seg.nii.gz,52,133,87,35,75,95,164,49,111,40,69,62
02741-101,../../DataSet/BraTS2024-BraTS-GLI-TrainingData/BraTS-GLI-02741-101/BraTS-GLI-02741-101-t1c.nii.gz,../../DataSet/BraTS2024-BraTS-GLI-TrainingData/BraTS-GLI-02741-101/BraTS-GLI-02741-101-t2w.nii.gz,../../DataSet/BraTS2024-BraTS-GLI-TrainingData/BraTS-GLI-02741-101/BraTS-GLI-02741-101-t2f.nii.gz,../../DataSet/BraTS2024-BraTS-GLI-TrainingData/BraTS-GLI-02741-101/BraTS-GLI-02741-101-t1n.nii.gz,../../DataSet/BraTS2024-BraTS-GLI-TrainingData/BraTS-GLI-02741-101/BraTS-GLI-02741-101-seg.nii.gz,84,69,84,77,91,58,82,75,95,14,24,20
02164-100,../../DataSet/BraTS2024-BraTS-GLI-TrainingData/BraTS-GLI-02164-100/BraTS-GLI-02164-100-t1c.nii.gz,../../DataSet/BraTS2024-BraTS-GLI-TrainingData/BraTS-GLI-02164-100/BraTS-GLI-02164-100-t2w.nii.gz,../../DataSet/BraTS2024-BraTS-GLI-TrainingData/BraTS-GLI-02164-100/BraTS-GLI-02164-100-t2f.nii.gz,../../DataSet/BraTS2024-BraTS-GLI-TrainingData/BraTS-GLI-02164-100/BraTS-GLI-02164-100-t1n.nii.gz,../../DataSet/BraTS2024-BraTS-GLI-TrainingData/BraTS-GLI-02164-100/BraTS-GLI-02164-100-seg.nii.gz,129,75,109,113,149,54,94,83,134,36,40,51
03052-100,../../DataSet/BraTS2024-BraTS-GLI-TrainingData/BraTS-GLI-03052-100/BraTS-GLI-03052-100-t1c.nii.gz,../../DataSet/BraTS2024-BraTS-GLI-TrainingData/BraTS-GLI-03052-100/BraTS-GLI-03052-100-t2w.nii.gz,../../DataSet/BraTS2024-BraTS-GLI-TrainingData/BraTS-GLI-03052-100/BraTS-GLI-03052-100-t2f.nii.gz,../../DataSet/BraTS2024-BraTS-GLI-TrainingData/BraTS-GLI-03052-100/BraTS-GLI-03052-100-t1n.nii.gz,../../DataSet/BraTS2024-BraTS-GLI-TrainingData/BraTS-GLI-03052-100/BraTS-GLI-03052-100-seg.nii.gz,107,142,98,67,141,113,162,80,117,74,49,37
02824-101,../../DataSet/BraTS2024-BraTS-GLI-TrainingData/BraTS-GLI-02824-101/BraTS-GLI-02824-101-t1c.nii.gz,../../DataSet/BraTS2024-BraTS-GLI-TrainingData/BraTS-GLI-02824-101/BraTS-GLI-02824-101-t2w.nii.gz,../../DataSet/BraTS2024-BraTS-GLI-TrainingData/BraTS-GLI-02824-101/BraTS-GLI-02824-101-t2f.nii.gz,../../DataSet/BraTS2024-BraTS-GLI-TrainingData/BraTS-GLI-02824-101/BraTS-GLI-02824-101-t1n.nii.gz,../../DataSet/BraTS2024-BraTS-GLI-TrainingData/BraTS-GLI-02824-101/BraTS-GLI-02824-101-seg.nii.gz,61,122,80,34,122,80,170,51,125,88,90,74
03059-101,../../DataSet/BraTS2024-BraTS-GLI-TrainingData/BraTS-GLI-03059-101/BraTS-GLI-03059-101-t1c.nii.gz,../../DataSet/BraTS2024-BraTS-GLI-TrainingData/BraTS-GLI-03059-101/BraTS-GLI-03059-101-t2w.nii.gz,../../DataSet/BraTS2024-BraTS-GLI-TrainingData/BraTS-GLI-03059-101/BraTS-GLI-03059-101-t2f.nii.gz,../../DataSet/BraTS2024-BraTS-GLI-TrainingData/BraTS-GLI-03059-101/BraTS-GLI-03059-101-t1n.nii.gz,../../DataSet/BraTS2024-BraTS-GLI-TrainingData/BraTS-GLI-03059-101/BraTS-GLI-03059-101-seg.nii.gz,137,79,64,104,159,32,117,44,99,55,85,55
02889-101,../../DataSet/BraTS2024-BraTS-GLI-TrainingData/BraTS-GLI-02889-101/BraTS-GLI-02889-101-t1c.nii.gz,../../DataSet/BraTS2024-BraTS-GLI-TrainingData/BraTS-GLI-02889-101/BraTS-GLI-02889-101-t2w.nii.gz,../../DataSet/BraTS2024-BraTS-GLI-TrainingData/BraTS-GLI-02889-101/BraTS-GLI-02889-101-t2f.nii.gz,../../DataSet/BraTS2024-BraTS-GLI-TrainingData/BraTS-GLI-02889-101/BraTS-GLI-02889-101-t1n.nii.gz,../../DataSet/BraTS2024-BraTS-GLI-TrainingData/BraTS-GLI-02889-101/BraTS-GLI-02889-101-seg.nii.gz,119,137,119,104,141,116,156,97,141,37,40,44
02237-102,../../DataSet/BraTS2024-BraTS-GLI-TrainingData/BraTS-GLI-02237-102/BraTS-GLI-02237-102-t1c.nii.gz,../../DataSet/BraTS2024-BraTS-GLI-TrainingData/BraTS-GLI-02237-102/BraTS-GLI-02237-102-t2w.nii.gz,../../DataSet/BraTS2024-BraTS-GLI-TrainingData/BraTS-GLI-02237-102/BraTS-GLI-02237-102-t2f.nii.gz,../../DataSet/BraTS2024-BraTS-GLI-TrainingData/BraTS-GLI-02237-102/BraTS-GLI-02237-102-t1n.nii.gz,../../DataSet/BraTS2024-BraTS-GLI-TrainingData/BraTS-GLI-02237-102/BraTS-GLI-02237-102-seg.nii.gz,76,155,111,52,136,112,191,71,141,84,79,70
02858-101,../../DataSet/BraTS2024-BraTS-GLI-TrainingData/BraTS-GLI-02858-101/BraTS-GLI-02858-101-t1c.nii.gz,../../DataSet/BraTS2024-BraTS-GLI-TrainingData/BraTS-GLI-02858-101/BraTS-GLI-02858-101-t2w.nii.gz,../../DataSet/BraTS2024-BraTS-GLI-TrainingData/BraTS-GLI-02858-101/BraTS-GLI-02858-101-t2f.nii.gz,../../DataSet/BraTS2024-BraTS-GLI-TrainingData/BraTS-GLI-02858-101/BraTS-GLI-02858-101-t1n.nii.gz,../../DataSet/BraTS2024-BraTS-GLI-TrainingData/BraTS-GLI-02858-101/BraTS-GLI-02858-101-seg.nii.gz,126,79,99,108,146,57,101,83,121,38,44,38
02736-100,../../DataSet/BraTS2024-BraTS-GLI-TrainingData/BraTS-GLI-02736-100/BraTS-GLI-02736-100-t1c.nii.gz,../../DataSet/BraTS2024-BraTS-GLI-TrainingData/BraTS-GLI-02736-100/BraTS-GLI-02736-100-t2w.nii.gz,../../DataSet/BraTS2024-BraTS-GLI-TrainingData/BraTS-GLI-02736-100/BraTS-GLI-02736-100-t2f.nii.gz,../../DataSet/BraTS2024-BraTS-GLI-TrainingData/BraTS-GLI-02736-100/BraTS-GLI-02736-100-t1n.nii.gz,../../DataSet/BraTS2024-BraTS-GLI-TrainingData/BraTS-GLI-02736-100/BraTS-GLI-02736-100-seg.nii.gz,71,130,96,52,87,117,148,87,113,35,31,26
00063-100,../../DataSet/BraTS2024-BraTS-GLI-TrainingData/BraTS-GLI-00063-100/BraTS-GLI-00063-100-t1c.nii.gz,../../DataSet/BraTS2024-BraTS-GLI-TrainingData/BraTS-GLI-00063-100/BraTS-GLI-00063-100-t2w.nii.gz,../../DataSet/BraTS2024-BraTS-GLI-TrainingData/BraTS-GLI-00063-100/BraTS-GLI-00063-100-t2f.nii.gz,../../DataSet/BraTS2024-BraTS-GLI-TrainingData/BraTS-GLI-00063-100/BraTS-GLI-00063-100-t1n.nii.gz,../../DataSet/BraTS2024-BraTS-GLI-TrainingData/BraTS-GLI-00063-100/BraTS-GLI-00063-100-seg.nii.gz,69,86,127,52,84,66,106,99,148,32,40,49
02882-100,../../DataSet/BraTS2024-BraTS-GLI-TrainingData/BraTS-GLI-02882-100/BraTS-GLI-02882-100-t1c.nii.gz,../../DataSet/BraTS2024-BraTS-GLI-TrainingData/BraTS-GLI-02882-100/BraTS-GLI-02882-100-t2w.nii.gz,../../DataSet/BraTS2024-BraTS-GLI-TrainingData/BraTS-GLI-02882-100/BraTS-GLI-02882-100-t2f.nii.gz,../../DataSet/BraTS2024-BraTS-GLI-TrainingData/BraTS-GLI-02882-100/BraTS-GLI-02882-100-t1n.nii.gz,../../DataSet/BraTS2024-BraTS-GLI-TrainingData/BraTS-GLI-02882-100/BraTS-GLI-02882-100-seg.nii.gz,87,157,108,51,124,97,191,79,140,73,94,61
02062-104,../../DataSet/BraTS2024-BraTS-GLI-TrainingData/BraTS-GLI-02062-104/BraTS-GLI-02062-104-t1c.nii.gz,../../DataSet/BraTS2024-BraTS-GLI-TrainingData/BraTS-GLI-02062-104/BraTS-GLI-02062-104-t2w.nii.gz,../../DataSet/BraTS2024-BraTS-GLI-TrainingData/BraTS-GLI-02062-104/BraTS-GLI-02062-104-t2f.nii.gz,../../DataSet/BraTS2024-BraTS-GLI-TrainingData/BraTS-GLI-02062-104/BraTS-GLI-02062-104-t1n.nii.gz,../../DataSet/BraTS2024-BraTS-GLI-TrainingData/BraTS-GLI-02062-104/BraTS-GLI-02062-104-seg.nii.gz,52,86,95,30,79,41,130,60,124,49,89,64
02204-101,../../DataSet/BraTS2024-BraTS-GLI-TrainingData/BraTS-GLI-02204-101/BraTS-GLI-02204-101-t1c.nii.gz,../../DataSet/BraTS2024-BraTS-GLI-TrainingData/BraTS-GLI-02204-101/BraTS-GLI-02204-101-t2w.nii.gz,../../DataSet/BraTS2024-BraTS-GLI-TrainingData/BraTS-GLI-02204-101/BraTS-GLI-02204-101-t2f.nii.gz,../../DataSet/BraTS2024-BraTS-GLI-TrainingData/BraTS-GLI-02204-101/BraTS-GLI-02204-101-t1n.nii.gz,../../DataSet/BraTS2024-BraTS-GLI-TrainingData/BraTS-GLI-02204-101/BraTS-GLI-02204-101-seg.nii.gz,71,133,70,45,100,103,168,51,95,55,65,44
02386-100,../../DataSet/BraTS2024-BraTS-GLI-TrainingData/BraTS-GLI-02386-100/BraTS-GLI-02386-100-t1c.nii.gz,../../DataSet/BraTS2024-BraTS-GLI-TrainingData/BraTS-GLI-02386-100/BraTS-GLI-02386-100-t2w.nii.gz,../../DataSet/BraTS2024-BraTS-GLI-TrainingData/BraTS-GLI-02386-100/BraTS-GLI-02386-100-t2f.nii.gz,../../DataSet/BraTS2024-BraTS-GLI-TrainingData/BraTS-GLI-02386-100/BraTS-GLI-02386-100-t1n.nii.gz,../../DataSet/BraTS2024-BraTS-GLI-TrainingData/BraTS-GLI-02386-100/BraTS-GLI-02386-100-seg.nii.gz,45,116,77,26,72,88,141,63,91,46,53,28
03025-101,../../DataSet/BraTS2024-BraTS-GLI-TrainingData/BraTS-GLI-03025-101/BraTS-GLI-03025-101-t1c.nii.gz,../../DataSet/BraTS2024-BraTS-GLI-TrainingData/BraTS-GLI-03025-101/BraTS-GLI-03025-101-t2w.nii.gz,../../DataSet/BraTS2024-BraTS-GLI-TrainingData/BraTS-GLI-03025-101/BraTS-GLI-03025-101-t2f.nii.gz,../../DataSet/BraTS2024-BraTS-GLI-TrainingData/BraTS-GLI-03025-101/BraTS-GLI-03025-101-t1n.nii.gz,../../DataSet/BraTS2024-BraTS-GLI-TrainingData/BraTS-GLI-03025-101/BraTS-GLI-03025-101-seg.nii.gz,75,110,129,63,89,91,131,106,148,26,40,42
02105-106,../../DataSet/BraTS2024-BraTS-GLI-TrainingData/BraTS-GLI-02105-106/BraTS-GLI-02105-106-t1c.nii.gz,../../DataSet/BraTS2024-BraTS-GLI-TrainingData/BraTS-GLI-02105-106/BraTS-GLI-02105-106-t2w.nii.gz,../../DataSet/BraTS2024-BraTS-GLI-TrainingData/BraTS-GLI-02105-106/BraTS-GLI-02105-106-t2f.nii.gz,../../DataSet/BraTS2024-BraTS-GLI-TrainingData/BraTS-GLI-02105-106/BraTS-GLI-02105-106-t1n.nii.gz,../../DataSet/BraTS2024-BraTS-GLI-TrainingData/BraTS-GLI-02105-106/BraTS-GLI-02105-106-seg.nii.gz,63,86,104,39,90,44,125,61,152,51,81,91
02208-100,../../DataSet/BraTS2024-BraTS-GLI-TrainingData/BraTS-GLI-02208-100/BraTS-GLI-02208-100-t1c.nii.gz,../../DataSet/BraTS2024-BraTS-GLI-TrainingData/BraTS-GLI-02208-100/BraTS-GLI-02208-100-t2w.nii.gz,../../DataSet/BraTS2024-BraTS-GLI-TrainingData/BraTS-GLI-02208-100/BraTS-GLI-02208-100-t2f.nii.gz,../../DataSet/BraTS2024-BraTS-GLI-TrainingData/BraTS-GLI-02208-100/BraTS-GLI-02208-100-t1n.nii.gz,../../DataSet/BraTS2024-BraTS-GLI-TrainingData/BraTS-GLI-02208-100/BraTS-GLI-02208-100-seg.nii.gz,103,46,97,94,156,33,106,77,113,62,73,36
02230-102,../../DataSet/BraTS2024-BraTS-GLI-TrainingData/BraTS-GLI-02230-102/BraTS-GLI-02230-102-t1c.nii.gz,../../DataSet/BraTS2024-BraTS-GLI-TrainingData/BraTS-GLI-02230-102/BraTS-GLI-02230-102-t2w.nii.gz,../../DataSet/BraTS2024-BraTS-GLI-TrainingData/BraTS-GLI-02230-102/BraTS-GLI-02230-102-t2f.nii.gz,../../DataSet/BraTS2024-BraTS-GLI-TrainingData/BraTS-GLI-02230-102/BraTS-GLI-02230-102-t1n.nii.gz,../../DataSet/BraTS2024-BraTS-GLI-TrainingData/BraTS-GLI-02230-102/BraTS-GLI-02230-102-seg.nii.gz,107,131,120,57,146,104,159,93,151,89,55,58
02885-100,../../DataSet/BraTS2024-BraTS-GLI-TrainingData/BraTS-GLI-02885-100/BraTS-GLI-02885-100-t1c.nii.gz,../../DataSet/BraTS2024-BraTS-GLI-TrainingData/BraTS-GLI-02885-100/BraTS-GLI-02885-100-t2w.nii.gz,../../DataSet/BraTS2024-BraTS-GLI-TrainingData/BraTS-GLI-02885-100/BraTS-GLI-02885-100-t2f.nii.gz,../../DataSet/BraTS2024-BraTS-GLI-TrainingData/BraTS-GLI-02885-100/BraTS-GLI-02885-100-t1n.nii.gz,../../DataSet/BraTS2024-BraTS-GLI-TrainingData/BraTS-GLI-02885-100/BraTS-GLI-02885-100-seg.nii.gz,129,54,101,113,149,33,80,84,118,36,47,34
00556-101,../../DataSet/BraTS2024-BraTS-GLI-TrainingData/BraTS-GLI-00556-101/BraTS-GLI-00556-101-t1c.nii.gz,../../DataSet/BraTS2024-BraTS-GLI-TrainingData/BraTS-GLI-00556-101/BraTS-GLI-00556-101-t2w.nii.gz,../../DataSet/BraTS2024-BraTS-GLI-TrainingData/BraTS-GLI-00556-101/BraTS-GLI-00556-101-t2f.nii.gz,../../DataSet/BraTS2024-BraTS-GLI-TrainingData/BraTS-GLI-00556-101/BraTS-GLI-00556-101-t1n.nii.gz,../../DataSet/BraTS2024-BraTS-GLI-TrainingData/BraTS-GLI-00556-101/BraTS-GLI-00556-101-seg.nii.gz,51,67,106,28,75,39,106,82,129,47,67,47
02854-100,../../DataSet/BraTS2024-BraTS-GLI-TrainingData/BraTS-GLI-02854-100/BraTS-GLI-02854-100-t1c.nii.gz,../../DataSet/BraTS2024-BraTS-GLI-TrainingData/BraTS-GLI-02854-100/BraTS-GLI-02854-100-t2w.nii.gz,../../DataSet/BraTS2024-BraTS-GLI-TrainingData/BraTS-GLI-02854-100/BraTS-GLI-02854-100-t2f.nii.gz,../../DataSet/BraTS2024-BraTS-GLI-TrainingData/BraTS-GLI-02854-100/BraTS-GLI-02854-100-t1n.nii.gz,../../DataSet/BraTS2024-BraTS-GLI-TrainingData/BraTS-GLI-02854-100/BraTS-GLI-02854-100-seg.nii.gz,123,51,96,99,151,22,108,61,123,52,86,62
03022-101,../../DataSet/BraTS2024-BraTS-GLI-TrainingData/BraTS-GLI-03022-101/BraTS-GLI-03022-101-t1c.nii.gz,../../DataSet/BraTS2024-BraTS-GLI-TrainingData/BraTS-GLI-03022-101/BraTS-GLI-03022-101-t2w.nii.gz,../../DataSet/BraTS2024-BraTS-GLI-TrainingData/BraTS-GLI-03022-101/BraTS-GLI-03022-101-t2f.nii.gz,../../DataSet/BraTS2024-BraTS-GLI-TrainingData/BraTS-GLI-03022-101/BraTS-GLI-03022-101-t1n.nii.gz,../../DataSet/BraTS2024-BraTS-GLI-TrainingData/BraTS-GLI-03022-101/BraTS-GLI-03022-101-seg.nii.gz,60,96,129,49,76,85,108,113,147,27,23,34
00472-101,../../DataSet/BraTS2024-BraTS-GLI-TrainingData/BraTS-GLI-00472-101/BraTS-GLI-00472-101-t1c.nii.gz,../../DataSet/BraTS2024-BraTS-GLI-TrainingData/BraTS-GLI-00472-101/BraTS-GLI-00472-101-t2w.nii.gz,../../DataSet/BraTS2024-BraTS-GLI-TrainingData/BraTS-GLI-00472-101/BraTS-GLI-00472-101-t2f.nii.gz,../../DataSet/BraTS2024-BraTS-GLI-TrainingData/BraTS-GLI-00472-101/BraTS-GLI-00472-101-t1n.nii.gz,../../DataSet/BraTS2024-BraTS-GLI-TrainingData/BraTS-GLI-00472-101/BraTS-GLI-00472-101-seg.nii.gz,129,120,54,109,149,92,143,40,77,40,51,37
02970-100,../../DataSet/BraTS2024-BraTS-GLI-TrainingData/BraTS-GLI-02970-100/BraTS-GLI-02970-100-t1c.nii.gz,../../DataSet/BraTS2024-BraTS-GLI-TrainingData/BraTS-GLI-02970-100/BraTS-GLI-02970-100-t2w.nii.gz,../../DataSet/BraTS2024-BraTS-GLI-TrainingData/BraTS-GLI-02970-100/BraTS-GLI-02970-100-t2f.nii.gz,../../DataSet/BraTS2024-BraTS-GLI-TrainingData/BraTS-GLI-02970-100/BraTS-GLI-02970-100-t1n.nii.gz,../../DataSet/BraTS2024-BraTS-GLI-TrainingData/BraTS-GLI-02970-100/BraTS-GLI-02970-100-seg.nii.gz,69,165,101,38,115,135,200,74,131,77,65,57
02746-101,../../DataSet/BraTS2024-BraTS-GLI-TrainingData/BraTS-GLI-02746-101/BraTS-GLI-02746-101-t1c.nii.gz,../../DataSet/BraTS2024-BraTS-GLI-TrainingData/BraTS-GLI-02746-101/BraTS-GLI-02746-101-t2w.nii.gz,../../DataSet/BraTS2024-BraTS-GLI-TrainingData/BraTS-GLI-02746-101/BraTS-GLI-02746-101-t2f.nii.gz,../../DataSet/BraTS2024-BraTS-GLI-TrainingData/BraTS-GLI-02746-101/BraTS-GLI-02746-101-t1n.nii.gz,../../DataSet/BraTS2024-BraTS-GLI-TrainingData/BraTS-GLI-02746-101/BraTS-GLI-02746-101-seg.nii.gz,71,52,111,46,91,31,80,89,141,45,49,52
02797-101,../../DataSet/BraTS2024-BraTS-GLI-TrainingData/BraTS-GLI-02797-101/BraTS-GLI-02797-101-t1c.nii.gz,../../DataSet/BraTS2024-BraTS-GLI-TrainingData/BraTS-GLI-02797-101/BraTS-GLI-02797-101-t2w.nii.gz,../../DataSet/BraTS2024-BraTS-GLI-TrainingData/BraTS-GLI-02797-101/BraTS-GLI-02797-101-t2f.nii.gz,../../DataSet/BraTS2024-BraTS-GLI-TrainingData/BraTS-GLI-02797-101/BraTS-GLI-02797-101-t1n.nii.gz,../../DataSet/BraTS2024-BraTS-GLI-TrainingData/BraTS-GLI-02797-101/BraTS-GLI-02797-101-seg.nii.gz,60,84,110,38,76,45,122,84,131,38,77,47
03055-100,../../DataSet/BraTS2024-BraTS-GLI-TrainingData/BraTS-GLI-03055-100/BraTS-GLI-03055-100-t1c.nii.gz,../../DataSet/BraTS2024-BraTS-GLI-TrainingData/BraTS-GLI-03055-100/BraTS-GLI-03055-100-t2w.nii.gz,../../DataSet/BraTS2024-BraTS-GLI-TrainingData/BraTS-GLI-03055-100/BraTS-GLI-03055-100-t2f.nii.gz,../../DataSet/BraTS2024-BraTS-GLI-TrainingData/BraTS-GLI-03055-100/BraTS-GLI-03055-100-t1n.nii.gz,../../DataSet/BraTS2024-BraTS-GLI-TrainingData/BraTS-GLI-03055-100/BraTS-GLI-03055-100-seg.nii.gz,78,64,99,58,92,25,107,62,133,34,82,71
02274-100,../../DataSet/BraTS2024-BraTS-GLI-TrainingData/BraTS-GLI-02274-100/BraTS-GLI-02274-100-t1c.nii.gz,../../DataSet/BraTS2024-BraTS-GLI-TrainingData/BraTS-GLI-02274-100/BraTS-GLI-02274-100-t2w.nii.gz,../../DataSet/BraTS2024-BraTS-GLI-TrainingData/BraTS-GLI-02274-100/BraTS-GLI-02274-100-t2f.nii.gz,../../DataSet/BraTS2024-BraTS-GLI-TrainingData/BraTS-GLI-02274-100/BraTS-GLI-02274-100-t1n.nii.gz,../../DataSet/BraTS2024-BraTS-GLI-TrainingData/BraTS-GLI-02274-100/BraTS-GLI-02274-100-seg.nii.gz,108,108,119,72,131,66,146,83,149,59,80,66
02823-101,../../DataSet/BraTS2024-BraTS-GLI-TrainingData/BraTS-GLI-02823-101/BraTS-GLI-02823-101-t1c.nii.gz,../../DataSet/BraTS2024-BraTS-GLI-TrainingData/BraTS-GLI-02823-101/BraTS-GLI-02823-101-t2w.nii.gz,../../DataSet/BraTS2024-BraTS-GLI-TrainingData/BraTS-GLI-02823-101/BraTS-GLI-02823-101-t2f.nii.gz,../../DataSet/BraTS2024-BraTS-GLI-TrainingData/BraTS-GLI-02823-101/BraTS-GLI-02823-101-t1n.nii.gz,../../DataSet/BraTS2024-BraTS-GLI-TrainingData/BraTS-GLI-02823-101/BraTS-GLI-02823-101-seg.nii.gz,111,140,121,95,135,100,173,95,147,40,73,52
02247-103,../../DataSet/BraTS2024-BraTS-GLI-TrainingData/BraTS-GLI-02247-103/BraTS-GLI-02247-103-t1c.nii.gz,../../DataSet/BraTS2024-BraTS-GLI-TrainingData/BraTS-GLI-02247-103/BraTS-GLI-02247-103-t2w.nii.gz,../../DataSet/BraTS2024-BraTS-GLI-TrainingData/BraTS-GLI-02247-103/BraTS-GLI-02247-103-t2f.nii.gz,../../DataSet/BraTS2024-BraTS-GLI-TrainingData/BraTS-GLI-02247-103/BraTS-GLI-02247-103-t1n.nii.gz,../../DataSet/BraTS2024-BraTS-GLI-TrainingData/BraTS-GLI-02247-103/BraTS-GLI-02247-103-seg.nii.gz,46,123,107,32,65,101,148,77,141,33,47,64
02205-102,../../DataSet/BraTS2024-BraTS-GLI-TrainingData/BraTS-GLI-02205-102/BraTS-GLI-02205-102-t1c.nii.gz,../../DataSet/BraTS2024-BraTS-GLI-TrainingData/BraTS-GLI-02205-102/BraTS-GLI-02205-102-t2w.nii.gz,../../DataSet/BraTS2024-BraTS-GLI-TrainingData/BraTS-GLI-02205-102/BraTS-GLI-02205-102-t2f.nii.gz,../../DataSet/BraTS2024-BraTS-GLI-TrainingData/BraTS-GLI-02205-102/BraTS-GLI-02205-102-t1n.nii.gz,../../DataSet/BraTS2024-BraTS-GLI-TrainingData/BraTS-GLI-02205-102/BraTS-GLI-02205-102-seg.nii.gz,101,146,114,91,119,116,180,77,145,28,64,68
02112-102,../../DataSet/BraTS2024-BraTS-GLI-TrainingData/BraTS-GLI-02112-102/BraTS-GLI-02112-102-t1c.nii.gz,../../DataSet/BraTS2024-BraTS-GLI-TrainingData/BraTS-GLI-02112-102/BraTS-GLI-02112-102-t2w.nii.gz,../../DataSet/BraTS2024-BraTS-GLI-TrainingData/BraTS-GLI-02112-102/BraTS-GLI-02112-102-t2f.nii.gz,../../DataSet/BraTS2024-BraTS-GLI-TrainingData/BraTS-GLI-02112-102/BraTS-GLI-02112-102-t1n.nii.gz,../../DataSet/BraTS2024-BraTS-GLI-TrainingData/BraTS-GLI-02112-102/BraTS-GLI-02112-102-seg.nii.gz,64,66,116,37,86,34,124,79,156,49,90,77
02939-100,../../DataSet/BraTS2024-BraTS-GLI-TrainingData/BraTS-GLI-02939-100/BraTS-GLI-02939-100-t1c.nii.gz,../../DataSet/BraTS2024-BraTS-GLI-TrainingData/BraTS-GLI-02939-100/BraTS-GLI-02939-100-t2w.nii.gz,../../DataSet/BraTS2024-BraTS-GLI-TrainingData/BraTS-GLI-02939-100/BraTS-GLI-02939-100-t2f.nii.gz,../../DataSet/BraTS2024-BraTS-GLI-TrainingData/BraTS-GLI-02939-100/BraTS-GLI-02939-100-t1n.nii.gz,../../DataSet/BraTS2024-BraTS-GLI-TrainingData/BraTS-GLI-02939-100/BraTS-GLI-02939-100-seg.nii.gz,127,58,84,83,152,35,115,68,112,69,80,44
00080-100,../../DataSet/BraTS2024-BraTS-GLI-TrainingData/BraTS-GLI-00080-100/BraTS-GLI-00080-100-t1c.nii.gz,../../DataSet/BraTS2024-BraTS-GLI-TrainingData/BraTS-GLI-00080-100/BraTS-GLI-00080-100-t2w.nii.gz,../../DataSet/BraTS2024-BraTS-GLI-TrainingData/BraTS-GLI-00080-100/BraTS-GLI-00080-100-t2f.nii.gz,../../DataSet/BraTS2024-BraTS-GLI-TrainingData/BraTS-GLI-00080-100/BraTS-GLI-00080-100-t1n.nii.gz,../../DataSet/BraTS2024-BraTS-GLI-TrainingData/BraTS-GLI-00080-100/BraTS-GLI-00080-100-seg.nii.gz,106,102,123,72,131,67,143,98,150,59,76,52
03017-101,../../DataSet/BraTS2024-BraTS-GLI-TrainingData/BraTS-GLI-03017-101/BraTS-GLI-03017-101-t1c.nii.gz,../../DataSet/BraTS2024-BraTS-GLI-TrainingData/BraTS-GLI-03017-101/BraTS-GLI-03017-101-t2w.nii.gz,../../DataSet/BraTS2024-BraTS-GLI-TrainingData/BraTS-GLI-03017-101/BraTS-GLI-03017-101-t2f.nii.gz,../../DataSet/BraTS2024-BraTS-GLI-TrainingData/BraTS-GLI-03017-101/BraTS-GLI-03017-101-t1n.nii.gz,../../DataSet/BraTS2024-BraTS-GLI-TrainingData/BraTS-GLI-03017-101/BraTS-GLI-03017-101-seg.nii.gz,105,106,118,73,136,62,140,92,147,63,78,55
02072-100,../../DataSet/BraTS2024-BraTS-GLI-TrainingData/BraTS-GLI-02072-100/BraTS-GLI-02072-100-t1c.nii.gz,../../DataSet/BraTS2024-BraTS-GLI-TrainingData/BraTS-GLI-02072-100/BraTS-GLI-02072-100-t2w.nii.gz,../../DataSet/BraTS2024-BraTS-GLI-TrainingData/BraTS-GLI-02072-100/BraTS-GLI-02072-100-t2f.nii.gz,../../DataSet/BraTS2024-BraTS-GLI-TrainingData/BraTS-GLI-02072-100/BraTS-GLI-02072-100-t1n.nii.gz,../../DataSet/BraTS2024-BraTS-GLI-TrainingData/BraTS-GLI-02072-100/BraTS-GLI-02072-100-seg.nii.gz,52,95,81,34,77,64,130,55,119,43,66,64
02861-100,../../DataSet/BraTS2024-BraTS-GLI-TrainingData/BraTS-GLI-02861-100/BraTS-GLI-02861-100-t1c.nii.gz,../../DataSet/BraTS2024-BraTS-GLI-TrainingData/BraTS-GLI-02861-100/BraTS-GLI-02861-100-t2w.nii.gz,../../DataSet/BraTS2024-BraTS-GLI-TrainingData/BraTS-GLI-02861-100/BraTS-GLI-02861-100-t2f.nii.gz,../../DataSet/BraTS2024-BraTS-GLI-TrainingData/BraTS-GLI-02861-100/BraTS-GLI-02861-100-t1n.nii.gz,../../DataSet/BraTS2024-BraTS-GLI-TrainingData/BraTS-GLI-02861-100/BraTS-GLI-02861-100-seg.nii.gz,118,80,113,106,132,73,87,105,133,26,14,28
02236-101,../../DataSet/BraTS2024-BraTS-GLI-TrainingData/BraTS-GLI-02236-101/BraTS-GLI-02236-101-t1c.nii.gz,../../DataSet/BraTS2024-BraTS-GLI-TrainingData/BraTS-GLI-02236-101/BraTS-GLI-02236-101-t2w.nii.gz,../../DataSet/BraTS2024-BraTS-GLI-TrainingData/BraTS-GLI-02236-101/BraTS-GLI-02236-101-t2f.nii.gz,../../DataSet/BraTS2024-BraTS-GLI-TrainingData/BraTS-GLI-02236-101/BraTS-GLI-02236-101-t1n.nii.gz,../../DataSet/BraTS2024-BraTS-GLI-TrainingData/BraTS-GLI-02236-101/BraTS-GLI-02236-101-seg.nii.gz,135,131,90,126,145,121,141,77,101,19,20,24
02816-101,../../DataSet/BraTS2024-BraTS-GLI-TrainingData/BraTS-GLI-02816-101/BraTS-GLI-02816-101-t1c.nii.gz,../../DataSet/BraTS2024-BraTS-GLI-TrainingData/BraTS-GLI-02816-101/BraTS-GLI-02816-101-t2w.nii.gz,../../DataSet/BraTS2024-BraTS-GLI-TrainingData/BraTS-GLI-02816-101/BraTS-GLI-02816-101-t2f.nii.gz,../../DataSet/BraTS2024-BraTS-GLI-TrainingData/BraTS-GLI-02816-101/BraTS-GLI-02816-101-t1n.nii.gz,../../DataSet/BraTS2024-BraTS-GLI-TrainingData/BraTS-GLI-02816-101/BraTS-GLI-02816-101-seg.nii.gz,123,112,70,102,145,81,144,44,115,43,63,71
02241-100,../../DataSet/BraTS2024-BraTS-GLI-TrainingData/BraTS-GLI-02241-100/BraTS-GLI-02241-100-t1c.nii.gz,../../DataSet/BraTS2024-BraTS-GLI-TrainingData/BraTS-GLI-02241-100/BraTS-GLI-02241-100-t2w.nii.gz,../../DataSet/BraTS2024-BraTS-GLI-TrainingData/BraTS-GLI-02241-100/BraTS-GLI-02241-100-t2f.nii.gz,../../DataSet/BraTS2024-BraTS-GLI-TrainingData/BraTS-GLI-02241-100/BraTS-GLI-02241-100-t1n.nii.gz,../../DataSet/BraTS2024-BraTS-GLI-TrainingData/BraTS-GLI-02241-100/BraTS-GLI-02241-100-seg.nii.gz,109,159,88,86,142,122,197,47,134,56,75,87
02994-100,../../DataSet/BraTS2024-BraTS-GLI-TrainingData/BraTS-GLI-02994-100/BraTS-GLI-02994-100-t1c.nii.gz,../../DataSet/BraTS2024-BraTS-GLI-TrainingData/BraTS-GLI-02994-100/BraTS-GLI-02994-100-t2w.nii.gz,../../DataSet/BraTS2024-BraTS-GLI-TrainingData/BraTS-GLI-02994-100/BraTS-GLI-02994-100-t2f.nii.gz,../../DataSet/BraTS2024-BraTS-GLI-TrainingData/BraTS-GLI-02994-100/BraTS-GLI-02994-100-t1n.nii.gz,../../DataSet/BraTS2024-BraTS-GLI-TrainingData/BraTS-GLI-02994-100/BraTS-GLI-02994-100-seg.nii.gz,66,142,122,36,112,101,173,88,157,76,72,69
03060-100,../../DataSet/BraTS2024-BraTS-GLI-TrainingData/BraTS-GLI-03060-100/BraTS-GLI-03060-100-t1c.nii.gz,../../DataSet/BraTS2024-BraTS-GLI-TrainingData/BraTS-GLI-03060-100/BraTS-GLI-03060-100-t2w.nii.gz,../../DataSet/BraTS2024-BraTS-GLI-TrainingData/BraTS-GLI-03060-100/BraTS-GLI-03060-100-t2f.nii.gz,../../DataSet/BraTS2024-BraTS-GLI-TrainingData/BraTS-GLI-03060-100/BraTS-GLI-03060-100-t1n.nii.gz,../../DataSet/BraTS2024-BraTS-GLI-TrainingData/BraTS-GLI-03060-100/BraTS-GLI-03060-100-seg.nii.gz,52,82,110,34,76,55,110,86,137,42,55,51
02773-101,../../DataSet/BraTS2024-BraTS-GLI-TrainingData/BraTS-GLI-02773-101/BraTS-GLI-02773-101-t1c.nii.gz,../../DataSet/BraTS2024-BraTS-GLI-TrainingData/BraTS-GLI-02773-101/BraTS-GLI-02773-101-t2w.nii.gz,../../DataSet/BraTS2024-BraTS-GLI-TrainingData/BraTS-GLI-02773-101/BraTS-GLI-02773-101-t2f.nii.gz,../../DataSet/BraTS2024-BraTS-GLI-TrainingData/BraTS-GLI-02773-101/BraTS-GLI-02773-101-t1n.nii.gz,../../DataSet/BraTS2024-BraTS-GLI-TrainingData/BraTS-GLI-02773-101/BraTS-GLI-02773-101-seg.nii.gz,128,91,102,106,153,54,135,75,131,47,81,56
02290-100,../../DataSet/BraTS2024-BraTS-GLI-TrainingData/BraTS-GLI-02290-100/BraTS-GLI-02290-100-t1c.nii.gz,../../DataSet/BraTS2024-BraTS-GLI-TrainingData/BraTS-GLI-02290-100/BraTS-GLI-02290-100-t2w.nii.gz,../../DataSet/BraTS2024-BraTS-GLI-TrainingData/BraTS-GLI-02290-100/BraTS-GLI-02290-100-t2f.nii.gz,../../DataSet/BraTS2024-BraTS-GLI-TrainingData/BraTS-GLI-02290-100/BraTS-GLI-02290-100-t1n.nii.gz,../../DataSet/BraTS2024-BraTS-GLI-TrainingData/BraTS-GLI-02290-100/BraTS-GLI-02290-100-seg.nii.gz,98,117,120,64,125,69,158,86,150,61,89,64
02319-100,../../DataSet/BraTS2024-BraTS-GLI-TrainingData/BraTS-GLI-02319-100/BraTS-GLI-02319-100-t1c.nii.gz,../../DataSet/BraTS2024-BraTS-GLI-TrainingData/BraTS-GLI-02319-100/BraTS-GLI-02319-100-t2w.nii.gz,../../DataSet/BraTS2024-BraTS-GLI-TrainingData/BraTS-GLI-02319-100/BraTS-GLI-02319-100-t2f.nii.gz,../../DataSet/BraTS2024-BraTS-GLI-TrainingData/BraTS-GLI-02319-100/BraTS-GLI-02319-100-t1n.nii.gz,../../DataSet/BraTS2024-BraTS-GLI-TrainingData/BraTS-GLI-02319-100/BraTS-GLI-02319-100-seg.nii.gz,86,116,116,41,127,73,160,88,151,86,87,63
02778-100,../../DataSet/BraTS2024-BraTS-GLI-TrainingData/BraTS-GLI-02778-100/BraTS-GLI-02778-100-t1c.nii.gz,../../DataSet/BraTS2024-BraTS-GLI-TrainingData/BraTS-GLI-02778-100/BraTS-GLI-02778-100-t2w.nii.gz,../../DataSet/BraTS2024-BraTS-GLI-TrainingData/BraTS-GLI-02778-100/BraTS-GLI-02778-100-t2f.nii.gz,../../DataSet/BraTS2024-BraTS-GLI-TrainingData/BraTS-GLI-02778-100/BraTS-GLI-02778-100-t1n.nii.gz,../../DataSet/BraTS2024-BraTS-GLI-TrainingData/BraTS-GLI-02778-100/BraTS-GLI-02778-100-seg.nii.gz,51,109,88,23,94,63,155,36,129,71,92,93
02993-100,../../DataSet/BraTS2024-BraTS-GLI-TrainingData/BraTS-GLI-02993-100/BraTS-GLI-02993-100-t1c.nii.gz,../../DataSet/BraTS2024-BraTS-GLI-TrainingData/BraTS-GLI-02993-100/BraTS-GLI-02993-100-t2w.nii.gz,../../DataSet/BraTS2024-BraTS-GLI-TrainingData/BraTS-GLI-02993-100/BraTS-GLI-02993-100-t2f.nii.gz,../../DataSet/BraTS2024-BraTS-GLI-TrainingData/BraTS-GLI-02993-100/BraTS-GLI-02993-100-t1n.nii.gz,../../DataSet/BraTS2024-BraTS-GLI-TrainingData/BraTS-GLI-02993-100/BraTS-GLI-02993-100-seg.nii.gz,56,130,94,39,77,114,150,80,109,38,36,29
02246-100,../../DataSet/BraTS2024-BraTS-GLI-TrainingData/BraTS-GLI-02246-100/BraTS-GLI-02246-100-t1c.nii.gz,../../DataSet/BraTS2024-BraTS-GLI-TrainingData/BraTS-GLI-02246-100/BraTS-GLI-02246-100-t2w.nii.gz,../../DataSet/BraTS2024-BraTS-GLI-TrainingData/BraTS-GLI-02246-100/BraTS-GLI-02246-100-t2f.nii.gz,../../DataSet/BraTS2024-BraTS-GLI-TrainingData/BraTS-GLI-02246-100/BraTS-GLI-02246-100-t1n.nii.gz,../../DataSet/BraTS2024-BraTS-GLI-TrainingData/BraTS-GLI-02246-100/BraTS-GLI-02246-100-seg.nii.gz,59,134,69,47,89,116,154,52,85,42,38,33
02774-101,../../DataSet/BraTS2024-BraTS-GLI-TrainingData/BraTS-GLI-02774-101/BraTS-GLI-02774-101-t1c.nii.gz,../../DataSet/BraTS2024-BraTS-GLI-TrainingData/BraTS-GLI-02774-101/BraTS-GLI-02774-101-t2w.nii.gz,../../DataSet/BraTS2024-BraTS-GLI-TrainingData/BraTS-GLI-02774-101/BraTS-GLI-02774-101-t2f.nii.gz,../../DataSet/BraTS2024-BraTS-GLI-TrainingData/BraTS-GLI-02774-101/BraTS-GLI-02774-101-t1n.nii.gz,../../DataSet/BraTS2024-BraTS-GLI-TrainingData/BraTS-GLI-02774-101/BraTS-GLI-02774-101-seg.nii.gz,60,76,108,34,101,37,127,66,141,67,90,75
02169-102,../../DataSet/BraTS2024-BraTS-GLI-TrainingData/BraTS-GLI-02169-102/BraTS-GLI-02169-102-t1c.nii.gz,../../DataSet/BraTS2024-BraTS-GLI-TrainingData/BraTS-GLI-02169-102/BraTS-GLI-02169-102-t2w.nii.gz,../../DataSet/BraTS2024-BraTS-GLI-TrainingData/BraTS-GLI-02169-102/BraTS-GLI-02169-102-t2f.nii.gz,../../DataSet/BraTS2024-BraTS-GLI-TrainingData/BraTS-GLI-02169-102/BraTS-GLI-02169-102-t1n.nii.gz,../../DataSet/BraTS2024-BraTS-GLI-TrainingData/BraTS-GLI-02169-102/BraTS-GLI-02169-102-seg.nii.gz,129,86,86,103,154,39,132,50,122,51,93,72
00518-101,../../DataSet/BraTS2024-BraTS-GLI-TrainingData/BraTS-GLI-00518-101/BraTS-GLI-00518-101-t1c.nii.gz,../../DataSet/BraTS2024-BraTS-GLI-TrainingData/BraTS-GLI-00518-101/BraTS-GLI-00518-101-t2w.nii.gz,../../DataSet/BraTS2024-BraTS-GLI-TrainingData/BraTS-GLI-00518-101/BraTS-GLI-00518-101-t2f.nii.gz,../../DataSet/BraTS2024-BraTS-GLI-TrainingData/BraTS-GLI-00518-101/BraTS-GLI-00518-101-t1n.nii.gz,../../DataSet/BraTS2024-BraTS-GLI-TrainingData/BraTS-GLI-00518-101/BraTS-GLI-00518-101-seg.nii.gz,121,127,101,104,140,109,148,83,117,36,39,34
02949-101,../../DataSet/BraTS2024-BraTS-GLI-TrainingData/BraTS-GLI-02949-101/BraTS-GLI-02949-101-t1c.nii.gz,../../DataSet/BraTS2024-BraTS-GLI-TrainingData/BraTS-GLI-02949-101/BraTS-GLI-02949-101-t2w.nii.gz,../../DataSet/BraTS2024-BraTS-GLI-TrainingData/BraTS-GLI-02949-101/BraTS-GLI-02949-101-t2f.nii.gz,../../DataSet/BraTS2024-BraTS-GLI-TrainingData/BraTS-GLI-02949-101/BraTS-GLI-02949-101-t1n.nii.gz,../../DataSet/BraTS2024-BraTS-GLI-TrainingData/BraTS-GLI-02949-101/BraTS-GLI-02949-101-seg.nii.gz,50,68,107,22,90,43,103,71,135,68,60,64
02218-104,../../DataSet/BraTS2024-BraTS-GLI-TrainingData/BraTS-GLI-02218-104/BraTS-GLI-02218-104-t1c.nii.gz,../../DataSet/BraTS2024-BraTS-GLI-TrainingData/BraTS-GLI-02218-104/BraTS-GLI-02218-104-t2w.nii.gz,../../DataSet/BraTS2024-BraTS-GLI-TrainingData/BraTS-GLI-02218-104/BraTS-GLI-02218-104-t2f.nii.gz,../../DataSet/BraTS2024-BraTS-GLI-TrainingData/BraTS-GLI-02218-104/BraTS-GLI-02218-104-t1n.nii.gz,../../DataSet/BraTS2024-BraTS-GLI-TrainingData/BraTS-GLI-02218-104/BraTS-GLI-02218-104-seg.nii.gz,123,128,79,105,146,98,154,54,107,41,56,53
02209-103,../../DataSet/BraTS2024-BraTS-GLI-TrainingData/BraTS-GLI-02209-103/BraTS-GLI-02209-103-t1c.nii.gz,../../DataSet/BraTS2024-BraTS-GLI-TrainingData/BraTS-GLI-02209-103/BraTS-GLI-02209-103-t2w.nii.gz,../../DataSet/BraTS2024-BraTS-GLI-TrainingData/BraTS-GLI-02209-103/BraTS-GLI-02209-103-t2f.nii.gz,../../DataSet/BraTS2024-BraTS-GLI-TrainingData/BraTS-GLI-02209-103/BraTS-GLI-02209-103-t1n.nii.gz,../../DataSet/BraTS2024-BraTS-GLI-TrainingData/BraTS-GLI-02209-103/BraTS-GLI-02209-103-seg.nii.gz,59,128,96,32,90,95,168,51,140,58,73,89
02866-100,../../DataSet/BraTS2024-BraTS-GLI-TrainingData/BraTS-GLI-02866-100/BraTS-GLI-02866-100-t1c.nii.gz,../../DataSet/BraTS2024-BraTS-GLI-TrainingData/BraTS-GLI-02866-100/BraTS-GLI-02866-100-t2w.nii.gz,../../DataSet/BraTS2024-BraTS-GLI-TrainingData/BraTS-GLI-02866-100/BraTS-GLI-02866-100-t2f.nii.gz,../../DataSet/BraTS2024-BraTS-GLI-TrainingData/BraTS-GLI-02866-100/BraTS-GLI-02866-100-t1n.nii.gz,../../DataSet/BraTS2024-BraTS-GLI-TrainingData/BraTS-GLI-02866-100/BraTS-GLI-02866-100-seg.nii.gz,128,126,64,101,156,89,156,40,92,55,67,52
02547-101,../../DataSet/BraTS2024-BraTS-GLI-TrainingData/BraTS-GLI-02547-101/BraTS-GLI-02547-101-t1c.nii.gz,../../DataSet/BraTS2024-BraTS-GLI-TrainingData/BraTS-GLI-02547-101/BraTS-GLI-02547-101-t2w.nii.gz,../../DataSet/BraTS2024-BraTS-GLI-TrainingData/BraTS-GLI-02547-101/BraTS-GLI-02547-101-t2f.nii.gz,../../DataSet/BraTS2024-BraTS-GLI-TrainingData/BraTS-GLI-02547-101/BraTS-GLI-02547-101-t1n.nii.gz,../../DataSet/BraTS2024-BraTS-GLI-TrainingData/BraTS-GLI-02547-101/BraTS-GLI-02547-101-seg.nii.gz,76,92,115,64,92,73,114,97,144,28,41,47
02248-100,../../DataSet/BraTS2024-BraTS-GLI-TrainingData/BraTS-GLI-02248-100/BraTS-GLI-02248-100-t1c.nii.gz,../../DataSet/BraTS2024-BraTS-GLI-TrainingData/BraTS-GLI-02248-100/BraTS-GLI-02248-100-t2w.nii.gz,../../DataSet/BraTS2024-BraTS-GLI-TrainingData/BraTS-GLI-02248-100/BraTS-GLI-02248-100-t2f.nii.gz,../../DataSet/BraTS2024-BraTS-GLI-TrainingData/BraTS-GLI-02248-100/BraTS-GLI-02248-100-t1n.nii.gz,../../DataSet/BraTS2024-BraTS-GLI-TrainingData/BraTS-GLI-02248-100/BraTS-GLI-02248-100-seg.nii.gz,104,78,102,64,126,57,110,71,133,62,53,62
02243-101,../../DataSet/BraTS2024-BraTS-GLI-TrainingData/BraTS-GLI-02243-101/BraTS-GLI-02243-101-t1c.nii.gz,../../DataSet/BraTS2024-BraTS-GLI-TrainingData/BraTS-GLI-02243-101/BraTS-GLI-02243-101-t2w.nii.gz,../../DataSet/BraTS2024-BraTS-GLI-TrainingData/BraTS-GLI-02243-101/BraTS-GLI-02243-101-t2f.nii.gz,../../DataSet/BraTS2024-BraTS-GLI-TrainingData/BraTS-GLI-02243-101/BraTS-GLI-02243-101-t1n.nii.gz,../../DataSet/BraTS2024-BraTS-GLI-TrainingData/BraTS-GLI-02243-101/BraTS-GLI-02243-101-seg.nii.gz,77,115,131,64,89,89,142,107,153,25,53,46
02154-101,../../DataSet/BraTS2024-BraTS-GLI-TrainingData/BraTS-GLI-02154-101/BraTS-GLI-02154-101-t1c.nii.gz,../../DataSet/BraTS2024-BraTS-GLI-TrainingData/BraTS-GLI-02154-101/BraTS-GLI-02154-101-t2w.nii.gz,../../DataSet/BraTS2024-BraTS-GLI-TrainingData/BraTS-GLI-02154-101/BraTS-GLI-02154-101-t2f.nii.gz,../../DataSet/BraTS2024-BraTS-GLI-TrainingData/BraTS-GLI-02154-101/BraTS-GLI-02154-101-t1n.nii.gz,../../DataSet/BraTS2024-BraTS-GLI-TrainingData/BraTS-GLI-02154-101/BraTS-GLI-02154-101-seg.nii.gz,111,153,89,69,149,104,191,51,141,80,87,90
02863-101,../../DataSet/BraTS2024-BraTS-GLI-TrainingData/BraTS-GLI-02863-101/BraTS-GLI-02863-101-t1c.nii.gz,../../DataSet/BraTS2024-BraTS-GLI-TrainingData/BraTS-GLI-02863-101/BraTS-GLI-02863-101-t2w.nii.gz,../../DataSet/BraTS2024-BraTS-GLI-TrainingData/BraTS-GLI-02863-101/BraTS-GLI-02863-101-t2f.nii.gz,../../DataSet/BraTS2024-BraTS-GLI-TrainingData/BraTS-GLI-02863-101/BraTS-GLI-02863-101-t1n.nii.gz,../../DataSet/BraTS2024-BraTS-GLI-TrainingData/BraTS-GLI-02863-101/BraTS-GLI-02863-101-seg.nii.gz,52,63,75,27,81,31,104,48,113,54,73,65
03015-100,../../DataSet/BraTS2024-BraTS-GLI-TrainingData/BraTS-GLI-03015-100/BraTS-GLI-03015-100-t1c.nii.gz,../../DataSet/BraTS2024-BraTS-GLI-TrainingData/BraTS-GLI-03015-100/BraTS-GLI-03015-100-t2w.nii.gz,../../DataSet/BraTS2024-BraTS-GLI-TrainingData/BraTS-GLI-03015-100/BraTS-GLI-03015-100-t2f.nii.gz,../../DataSet/BraTS2024-BraTS-GLI-TrainingData/BraTS-GLI-03015-100/BraTS-GLI-03015-100-t1n.nii.gz,../../DataSet/BraTS2024-BraTS-GLI-TrainingData/BraTS-GLI-03015-100/BraTS-GLI-03015-100-seg.nii.gz,42,75,65,23,71,32,116,47,95,48,84,48
02123-100,../../DataSet/BraTS2024-BraTS-GLI-TrainingData/BraTS-GLI-02123-100/BraTS-GLI-02123-100-t1c.nii.gz,../../DataSet/BraTS2024-BraTS-GLI-TrainingData/BraTS-GLI-02123-100/BraTS-GLI-02123-100-t2w.nii.gz,../../DataSet/BraTS2024-BraTS-GLI-TrainingData/BraTS-GLI-02123-100/BraTS-GLI-02123-100-t2f.nii.gz,../../DataSet/BraTS2024-BraTS-GLI-TrainingData/BraTS-GLI-02123-100/BraTS-GLI-02123-100-t1n.nii.gz,../../DataSet/BraTS2024-BraTS-GLI-TrainingData/BraTS-GLI-02123-100/BraTS-GLI-02123-100-seg.nii.gz,72,66,62,51,91,43,91,45,79,40,48,34
02549-101,../../DataSet/BraTS2024-BraTS-GLI-TrainingData/BraTS-GLI-02549-101/BraTS-GLI-02549-101-t1c.nii.gz,../../DataSet/BraTS2024-BraTS-GLI-TrainingData/BraTS-GLI-02549-101/BraTS-GLI-02549-101-t2w.nii.gz,../../DataSet/BraTS2024-BraTS-GLI-TrainingData/BraTS-GLI-02549-101/BraTS-GLI-02549-101-t2f.nii.gz,../../DataSet/BraTS2024-BraTS-GLI-TrainingData/BraTS-GLI-02549-101/BraTS-GLI-02549-101-t1n.nii.gz,../../DataSet/BraTS2024-BraTS-GLI-TrainingData/BraTS-GLI-02549-101/BraTS-GLI-02549-101-seg.nii.gz,43,74,79,32,76,36,95,63,98,44,59,35
02092-102,../../DataSet/BraTS2024-BraTS-GLI-TrainingData/BraTS-GLI-02092-102/BraTS-GLI-02092-102-t1c.nii.gz,../../DataSet/BraTS2024-BraTS-GLI-TrainingData/BraTS-GLI-02092-102/BraTS-GLI-02092-102-t2w.nii.gz,../../DataSet/BraTS2024-BraTS-GLI-TrainingData/BraTS-GLI-02092-102/BraTS-GLI-02092-102-t2f.nii.gz,../../DataSet/BraTS2024-BraTS-GLI-TrainingData/BraTS-GLI-02092-102/BraTS-GLI-02092-102-t1n.nii.gz,../../DataSet/BraTS2024-BraTS-GLI-TrainingData/BraTS-GLI-02092-102/BraTS-GLI-02092-102-seg.nii.gz,97,161,97,57,125,112,195,65,135,68,83,70
02128-101,../../DataSet/BraTS2024-BraTS-GLI-TrainingData/BraTS-GLI-02128-101/BraTS-GLI-02128-101-t1c.nii.gz,../../DataSet/BraTS2024-BraTS-GLI-TrainingData/BraTS-GLI-02128-101/BraTS-GLI-02128-101-t2w.nii.gz,../../DataSet/BraTS2024-BraTS-GLI-TrainingData/BraTS-GLI-02128-101/BraTS-GLI-02128-101-t2f.nii.gz,../../DataSet/BraTS2024-BraTS-GLI-TrainingData/BraTS-GLI-02128-101/BraTS-GLI-02128-101-t1n.nii.gz,../../DataSet/BraTS2024-BraTS-GLI-TrainingData/BraTS-GLI-02128-101/BraTS-GLI-02128-101-seg.nii.gz,76,83,121,44,131,49,122,86,155,87,73,69
00085-101,../../DataSet/BraTS2024-BraTS-GLI-TrainingData/BraTS-GLI-00085-101/BraTS-GLI-00085-101-t1c.nii.gz,../../DataSet/BraTS2024-BraTS-GLI-TrainingData/BraTS-GLI-00085-101/BraTS-GLI-00085-101-t2w.nii.gz,../../DataSet/BraTS2024-BraTS-GLI-TrainingData/BraTS-GLI-00085-101/BraTS-GLI-00085-101-t2f.nii.gz,../../DataSet/BraTS2024-BraTS-GLI-TrainingData/BraTS-GLI-00085-101/BraTS-GLI-00085-101-t1n.nii.gz,../../DataSet/BraTS2024-BraTS-GLI-TrainingData/BraTS-GLI-00085-101/BraTS-GLI-00085-101-seg.nii.gz,108,64,113,61,128,34,99,75,145,67,65,70
02124-100,../../DataSet/BraTS2024-BraTS-GLI-TrainingData/BraTS-GLI-02124-100/BraTS-GLI-02124-100-t1c.nii.gz,../../DataSet/BraTS2024-BraTS-GLI-TrainingData/BraTS-GLI-02124-100/BraTS-GLI-02124-100-t2w.nii.gz,../../DataSet/BraTS2024-BraTS-GLI-TrainingData/BraTS-GLI-02124-100/BraTS-GLI-02124-100-t2f.nii.gz,../../DataSet/BraTS2024-BraTS-GLI-TrainingData/BraTS-GLI-02124-100/BraTS-GLI-02124-100-t1n.nii.gz,../../DataSet/BraTS2024-BraTS-GLI-TrainingData/BraTS-GLI-02124-100/BraTS-GLI-02124-100-seg.nii.gz,57,112,59,36,81,82,141,38,81,45,59,43
02937-100,../../DataSet/BraTS2024-BraTS-GLI-TrainingData/BraTS-GLI-02937-100/BraTS-GLI-02937-100-t1c.nii.gz,../../DataSet/BraTS2024-BraTS-GLI-TrainingData/BraTS-GLI-02937-100/BraTS-GLI-02937-100-t2w.nii.gz,../../DataSet/BraTS2024-BraTS-GLI-TrainingData/BraTS-GLI-02937-100/BraTS-GLI-02937-100-t2f.nii.gz,../../DataSet/BraTS2024-BraTS-GLI-TrainingData/BraTS-GLI-02937-100/BraTS-GLI-02937-100-t1n.nii.gz,../../DataSet/BraTS2024-BraTS-GLI-TrainingData/BraTS-GLI-02937-100/BraTS-GLI-02937-100-seg.nii.gz,97,96,106,54,128,48,143,70,141,74,95,71
02238-101,../../DataSet/BraTS2024-BraTS-GLI-TrainingData/BraTS-GLI-02238-101/BraTS-GLI-02238-101-t1c.nii.gz,../../DataSet/BraTS2024-BraTS-GLI-TrainingData/BraTS-GLI-02238-101/BraTS-GLI-02238-101-t2w.nii.gz,../../DataSet/BraTS2024-BraTS-GLI-TrainingData/BraTS-GLI-02238-101/BraTS-GLI-02238-101-t2f.nii.gz,../../DataSet/BraTS2024-BraTS-GLI-TrainingData/BraTS-GLI-02238-101/BraTS-GLI-02238-101-t1n.nii.gz,../../DataSet/BraTS2024-BraTS-GLI-TrainingData/BraTS-GLI-02238-101/BraTS-GLI-02238-101-seg.nii.gz,76,164,100,55,92,132,201,72,135,37,69,63
02818-101,../../DataSet/BraTS2024-BraTS-GLI-TrainingData/BraTS-GLI-02818-101/BraTS-GLI-02818-101-t1c.nii.gz,../../DataSet/BraTS2024-BraTS-GLI-TrainingData/BraTS-GLI-02818-101/BraTS-GLI-02818-101-t2w.nii.gz,../../DataSet/BraTS2024-BraTS-GLI-TrainingData/BraTS-GLI-02818-101/BraTS-GLI-02818-101-t2f.nii.gz,../../DataSet/BraTS2024-BraTS-GLI-TrainingData/BraTS-GLI-02818-101/BraTS-GLI-02818-101-t1n.nii.gz,../../DataSet/BraTS2024-BraTS-GLI-TrainingData/BraTS-GLI-02818-101/BraTS-GLI-02818-101-seg.nii.gz,119,145,70,88,148,97,190,42,98,60,93,56
00511-101,../../DataSet/BraTS2024-BraTS-GLI-TrainingData/BraTS-GLI-00511-101/BraTS-GLI-00511-101-t1c.nii.gz,../../DataSet/BraTS2024-BraTS-GLI-TrainingData/BraTS-GLI-00511-101/BraTS-GLI-00511-101-t2w.nii.gz,../../DataSet/BraTS2024-BraTS-GLI-TrainingData/BraTS-GLI-00511-101/BraTS-GLI-00511-101-t2f.nii.gz,../../DataSet/BraTS2024-BraTS-GLI-TrainingData/BraTS-GLI-00511-101/BraTS-GLI-00511-101-t1n.nii.gz,../../DataSet/BraTS2024-BraTS-GLI-TrainingData/BraTS-GLI-00511-101/BraTS-GLI-00511-101-seg.nii.gz,130,135,60,106,151,110,157,39,85,45,47,46
02244-101,../../DataSet/BraTS2024-BraTS-GLI-TrainingData/BraTS-GLI-02244-101/BraTS-GLI-02244-101-t1c.nii.gz,../../DataSet/BraTS2024-BraTS-GLI-TrainingData/BraTS-GLI-02244-101/BraTS-GLI-02244-101-t2w.nii.gz,../../DataSet/BraTS2024-BraTS-GLI-TrainingData/BraTS-GLI-02244-101/BraTS-GLI-02244-101-t2f.nii.gz,../../DataSet/BraTS2024-BraTS-GLI-TrainingData/BraTS-GLI-02244-101/BraTS-GLI-02244-101-t1n.nii.gz,../../DataSet/BraTS2024-BraTS-GLI-TrainingData/BraTS-GLI-02244-101/BraTS-GLI-02244-101-seg.nii.gz,74,144,107,50,92,113,180,67,145,42,67,78
02813-100,../../DataSet/BraTS2024-BraTS-GLI-TrainingData/BraTS-GLI-02813-100/BraTS-GLI-02813-100-t1c.nii.gz,../../DataSet/BraTS2024-BraTS-GLI-TrainingData/BraTS-GLI-02813-100/BraTS-GLI-02813-100-t2w.nii.gz,../../DataSet/BraTS2024-BraTS-GLI-TrainingData/BraTS-GLI-02813-100/BraTS-GLI-02813-100-t2f.nii.gz,../../DataSet/BraTS2024-BraTS-GLI-TrainingData/BraTS-GLI-02813-100/BraTS-GLI-02813-100-t1n.nii.gz,../../DataSet/BraTS2024-BraTS-GLI-TrainingData/BraTS-GLI-02813-100/BraTS-GLI-02813-100-seg.nii.gz,108,135,122,65,142,89,181,83,159,77,92,76
02317-100,../../DataSet/BraTS2024-BraTS-GLI-TrainingData/BraTS-GLI-02317-100/BraTS-GLI-02317-100-t1c.nii.gz,../../DataSet/BraTS2024-BraTS-GLI-TrainingData/BraTS-GLI-02317-100/BraTS-GLI-02317-100-t2w.nii.gz,../../DataSet/BraTS2024-BraTS-GLI-TrainingData/BraTS-GLI-02317-100/BraTS-GLI-02317-100-t2f.nii.gz,../../DataSet/BraTS2024-BraTS-GLI-TrainingData/BraTS-GLI-02317-100/BraTS-GLI-02317-100-t1n.nii.gz,../../DataSet/BraTS2024-BraTS-GLI-TrainingData/BraTS-GLI-02317-100/BraTS-GLI-02317-100-seg.nii.gz,48,96,124,34,94,82,109,65,141,60,27,76
02940-101,../../DataSet/BraTS2024-BraTS-GLI-TrainingData/BraTS-GLI-02940-101/BraTS-GLI-02940-101-t1c.nii.gz,../../DataSet/BraTS2024-BraTS-GLI-TrainingData/BraTS-GLI-02940-101/BraTS-GLI-02940-101-t2w.nii.gz,../../DataSet/BraTS2024-BraTS-GLI-TrainingData/BraTS-GLI-02940-101/BraTS-GLI-02940-101-t2f.nii.gz,../../DataSet/BraTS2024-BraTS-GLI-TrainingData/BraTS-GLI-02940-101/BraTS-GLI-02940-101-t1n.nii.gz,../../DataSet/BraTS2024-BraTS-GLI-TrainingData/BraTS-GLI-02940-101/BraTS-GLI-02940-101-seg.nii.gz,131,95,83,105,156,42,138,52,116,51,96,64
02776-100,../../DataSet/BraTS2024-BraTS-GLI-TrainingData/BraTS-GLI-02776-100/BraTS-GLI-02776-100-t1c.nii.gz,../../DataSet/BraTS2024-BraTS-GLI-TrainingData/BraTS-GLI-02776-100/BraTS-GLI-02776-100-t2w.nii.gz,../../DataSet/BraTS2024-BraTS-GLI-TrainingData/BraTS-GLI-02776-100/BraTS-GLI-02776-100-t2f.nii.gz,../../DataSet/BraTS2024-BraTS-GLI-TrainingData/BraTS-GLI-02776-100/BraTS-GLI-02776-100-t1n.nii.gz,../../DataSet/BraTS2024-BraTS-GLI-TrainingData/BraTS-GLI-02776-100/BraTS-GLI-02776-100-seg.nii.gz,115,109,121,99,140,77,148,93,144,41,71,51
03008-101,../../DataSet/BraTS2024-BraTS-GLI-TrainingData/BraTS-GLI-03008-101/BraTS-GLI-03008-101-t1c.nii.gz,../../DataSet/BraTS2024-BraTS-GLI-TrainingData/BraTS-GLI-03008-101/BraTS-GLI-03008-101-t2w.nii.gz,../../DataSet/BraTS2024-BraTS-GLI-TrainingData/BraTS-GLI-03008-101/BraTS-GLI-03008-101-t2f.nii.gz,../../DataSet/BraTS2024-BraTS-GLI-TrainingData/BraTS-GLI-03008-101/BraTS-GLI-03008-101-t1n.nii.gz,../../DataSet/BraTS2024-BraTS-GLI-TrainingData/BraTS-GLI-03008-101/BraTS-GLI-03008-101-seg.nii.gz,102,163,93,64,135,128,197,63,142,71,69,79
02135-100,../../DataSet/BraTS2024-BraTS-GLI-TrainingData/BraTS-GLI-02135-100/BraTS-GLI-02135-100-t1c.nii.gz,../../DataSet/BraTS2024-BraTS-GLI-TrainingData/BraTS-GLI-02135-100/BraTS-GLI-02135-100-t2w.nii.gz,../../DataSet/BraTS2024-BraTS-GLI-TrainingData/BraTS-GLI-02135-100/BraTS-GLI-02135-100-t2f.nii.gz,../../DataSet/BraTS2024-BraTS-GLI-TrainingData/BraTS-GLI-02135-100/BraTS-GLI-02135-100-t1n.nii.gz,../../DataSet/BraTS2024-BraTS-GLI-TrainingData/BraTS-GLI-02135-100/BraTS-GLI-02135-100-seg.nii.gz,74,157,111,49,93,110,191,80,147,44,81,67
02222-100,../../DataSet/BraTS2024-BraTS-GLI-TrainingData/BraTS-GLI-02222-100/BraTS-GLI-02222-100-t1c.nii.gz,../../DataSet/BraTS2024-BraTS-GLI-TrainingData/BraTS-GLI-02222-100/BraTS-GLI-02222-100-t2w.nii.gz,../../DataSet/BraTS2024-BraTS-GLI-TrainingData/BraTS-GLI-02222-100/BraTS-GLI-02222-100-t2f.nii.gz,../../DataSet/BraTS2024-BraTS-GLI-TrainingData/BraTS-GLI-02222-100/BraTS-GLI-02222-100-t1n.nii.gz,../../DataSet/BraTS2024-BraTS-GLI-TrainingData/BraTS-GLI-02222-100/BraTS-GLI-02222-100-seg.nii.gz,113,159,97,93,141,128,195,62,142,48,67,80
02875-101,../../DataSet/BraTS2024-BraTS-GLI-TrainingData/BraTS-GLI-02875-101/BraTS-GLI-02875-101-t1c.nii.gz,../../DataSet/BraTS2024-BraTS-GLI-TrainingData/BraTS-GLI-02875-101/BraTS-GLI-02875-101-t2w.nii.gz,../../DataSet/BraTS2024-BraTS-GLI-TrainingData/BraTS-GLI-02875-101/BraTS-GLI-02875-101-t2f.nii.gz,../../DataSet/BraTS2024-BraTS-GLI-TrainingData/BraTS-GLI-02875-101/BraTS-GLI-02875-101-t1n.nii.gz,../../DataSet/BraTS2024-BraTS-GLI-TrainingData/BraTS-GLI-02875-101/BraTS-GLI-02875-101-seg.nii.gz,72,146,109,35,114,93,182,69,145,79,89,76
02066-101,../../DataSet/BraTS2024-BraTS-GLI-TrainingData/BraTS-GLI-02066-101/BraTS-GLI-02066-101-t1c.nii.gz,../../DataSet/BraTS2024-BraTS-GLI-TrainingData/BraTS-GLI-02066-101/BraTS-GLI-02066-101-t2w.nii.gz,../../DataSet/BraTS2024-BraTS-GLI-TrainingData/BraTS-GLI-02066-101/BraTS-GLI-02066-101-t2f.nii.gz,../../DataSet/BraTS2024-BraTS-GLI-TrainingData/BraTS-GLI-02066-101/BraTS-GLI-02066-101-t1n.nii.gz,../../DataSet/BraTS2024-BraTS-GLI-TrainingData/BraTS-GLI-02066-101/BraTS-GLI-02066-101-seg.nii.gz,113,82,122,95,138,43,131,87,152,43,88,65
02767-100,../../DataSet/BraTS2024-BraTS-GLI-TrainingData/BraTS-GLI-02767-100/BraTS-GLI-02767-100-t1c.nii.gz,../../DataSet/BraTS2024-BraTS-GLI-TrainingData/BraTS-GLI-02767-100/BraTS-GLI-02767-100-t2w.nii.gz,../../DataSet/BraTS2024-BraTS-GLI-TrainingData/BraTS-GLI-02767-100/BraTS-GLI-02767-100-t2f.nii.gz,../../DataSet/BraTS2024-BraTS-GLI-TrainingData/BraTS-GLI-02767-100/BraTS-GLI-02767-100-t1n.nii.gz,../../DataSet/BraTS2024-BraTS-GLI-TrainingData/BraTS-GLI-02767-100/BraTS-GLI-02767-100-seg.nii.gz,97,90,23,91,103,86,96,18,33,12,10,15
02634-101,../../DataSet/BraTS2024-BraTS-GLI-TrainingData/BraTS-GLI-02634-101/BraTS-GLI-02634-101-t1c.nii.gz,../../DataSet/BraTS2024-BraTS-GLI-TrainingData/BraTS-GLI-02634-101/BraTS-GLI-02634-101-t2w.nii.gz,../../DataSet/BraTS2024-BraTS-GLI-TrainingData/BraTS-GLI-02634-101/BraTS-GLI-02634-101-t2f.nii.gz,../../DataSet/BraTS2024-BraTS-GLI-TrainingData/BraTS-GLI-02634-101/BraTS-GLI-02634-101-t1n.nii.gz,../../DataSet/BraTS2024-BraTS-GLI-TrainingData/BraTS-GLI-02634-101/BraTS-GLI-02634-101-seg.nii.gz,129,102,76,97,158,63,141,43,108,61,78,65
02193-101,../../DataSet/BraTS2024-BraTS-GLI-TrainingData/BraTS-GLI-02193-101/BraTS-GLI-02193-101-t1c.nii.gz,../../DataSet/BraTS2024-BraTS-GLI-TrainingData/BraTS-GLI-02193-101/BraTS-GLI-02193-101-t2w.nii.gz,../../DataSet/BraTS2024-BraTS-GLI-TrainingData/BraTS-GLI-02193-101/BraTS-GLI-02193-101-t2f.nii.gz,../../DataSet/BraTS2024-BraTS-GLI-TrainingData/BraTS-GLI-02193-101/BraTS-GLI-02193-101-t1n.nii.gz,../../DataSet/BraTS2024-BraTS-GLI-TrainingData/BraTS-GLI-02193-101/BraTS-GLI-02193-101-seg.nii.gz,124,81,115,96,152,49,126,78,147,56,77,69
02802-100,../../DataSet/BraTS2024-BraTS-GLI-TrainingData/BraTS-GLI-02802-100/BraTS-GLI-02802-100-t1c.nii.gz,../../DataSet/BraTS2024-BraTS-GLI-TrainingData/BraTS-GLI-02802-100/BraTS-GLI-02802-100-t2w.nii.gz,../../DataSet/BraTS2024-BraTS-GLI-TrainingData/BraTS-GLI-02802-100/BraTS-GLI-02802-100-t2f.nii.gz,../../DataSet/BraTS2024-BraTS-GLI-TrainingData/BraTS-GLI-02802-100/BraTS-GLI-02802-100-t1n.nii.gz,../../DataSet/BraTS2024-BraTS-GLI-TrainingData/BraTS-GLI-02802-100/BraTS-GLI-02802-100-seg.nii.gz,109,89,123,86,143,49,131,93,156,57,82,63
02980-101,../../DataSet/BraTS2024-BraTS-GLI-TrainingData/BraTS-GLI-02980-101/BraTS-GLI-02980-101-t1c.nii.gz,../../DataSet/BraTS2024-BraTS-GLI-TrainingData/BraTS-GLI-02980-101/BraTS-GLI-02980-101-t2w.nii.gz,../../DataSet/BraTS2024-BraTS-GLI-TrainingData/BraTS-GLI-02980-101/BraTS-GLI-02980-101-t2f.nii.gz,../../DataSet/BraTS2024-BraTS-GLI-TrainingData/BraTS-GLI-02980-101/BraTS-GLI-02980-101-t1n.nii.gz,../../DataSet/BraTS2024-BraTS-GLI-TrainingData/BraTS-GLI-02980-101/BraTS-GLI-02980-101-seg.nii.gz,57,129,87,37,78,95,154,66,105,41,59,39
02149-100,../../DataSet/BraTS2024-BraTS-GLI-TrainingData/BraTS-GLI-02149-100/BraTS-GLI-02149-100-t1c.nii.gz,../../DataSet/BraTS2024-BraTS-GLI-TrainingData/BraTS-GLI-02149-100/BraTS-GLI-02149-100-t2w.nii.gz,../../DataSet/BraTS2024-BraTS-GLI-TrainingData/BraTS-GLI-02149-100/BraTS-GLI-02149-100-t2f.nii.gz,../../DataSet/BraTS2024-BraTS-GLI-TrainingData/BraTS-GLI-02149-100/BraTS-GLI-02149-100-t1n.nii.gz,../../DataSet/BraTS2024-BraTS-GLI-TrainingData/BraTS-GLI-02149-100/BraTS-GLI-02149-100-seg.nii.gz,104,88,122,86,121,61,111,95,144,35,50,49
02809-101,../../DataSet/BraTS2024-BraTS-GLI-TrainingData/BraTS-GLI-02809-101/BraTS-GLI-02809-101-t1c.nii.gz,../../DataSet/BraTS2024-BraTS-GLI-TrainingData/BraTS-GLI-02809-101/BraTS-GLI-02809-101-t2w.nii.gz,../../DataSet/BraTS2024-BraTS-GLI-TrainingData/BraTS-GLI-02809-101/BraTS-GLI-02809-101-t2f.nii.gz,../../DataSet/BraTS2024-BraTS-GLI-TrainingData/BraTS-GLI-02809-101/BraTS-GLI-02809-101-t1n.nii.gz,../../DataSet/BraTS2024-BraTS-GLI-TrainingData/BraTS-GLI-02809-101/BraTS-GLI-02809-101-seg.nii.gz,72,150,120,53,88,105,181,92,146,35,76,54
02198-100,../../DataSet/BraTS2024-BraTS-GLI-TrainingData/BraTS-GLI-02198-100/BraTS-GLI-02198-100-t1c.nii.gz,../../DataSet/BraTS2024-BraTS-GLI-TrainingData/BraTS-GLI-02198-100/BraTS-GLI-02198-100-t2w.nii.gz,../../DataSet/BraTS2024-BraTS-GLI-TrainingData/BraTS-GLI-02198-100/BraTS-GLI-02198-100-t2f.nii.gz,../../DataSet/BraTS2024-BraTS-GLI-TrainingData/BraTS-GLI-02198-100/BraTS-GLI-02198-100-t1n.nii.gz,../../DataSet/BraTS2024-BraTS-GLI-TrainingData/BraTS-GLI-02198-100/BraTS-GLI-02198-100-seg.nii.gz,60,66,95,33,117,28,117,64,128,84,89,64
02524-101,../../DataSet/BraTS2024-BraTS-GLI-TrainingData/BraTS-GLI-02524-101/BraTS-GLI-02524-101-t1c.nii.gz,../../DataSet/BraTS2024-BraTS-GLI-TrainingData/BraTS-GLI-02524-101/BraTS-GLI-02524-101-t2w.nii.gz,../../DataSet/BraTS2024-BraTS-GLI-TrainingData/BraTS-GLI-02524-101/BraTS-GLI-02524-101-t2f.nii.gz,../../DataSet/BraTS2024-BraTS-GLI-TrainingData/BraTS-GLI-02524-101/BraTS-GLI-02524-101-t1n.nii.gz,../../DataSet/BraTS2024-BraTS-GLI-TrainingData/BraTS-GLI-02524-101/BraTS-GLI-02524-101-seg.nii.gz,107,109,127,92,128,92,130,107,142,36,38,35
02760-100,../../DataSet/BraTS2024-BraTS-GLI-TrainingData/BraTS-GLI-02760-100/BraTS-GLI-02760-100-t1c.nii.gz,../../DataSet/BraTS2024-BraTS-GLI-TrainingData/BraTS-GLI-02760-100/BraTS-GLI-02760-100-t2w.nii.gz,../../DataSet/BraTS2024-BraTS-GLI-TrainingData/BraTS-GLI-02760-100/BraTS-GLI-02760-100-t2f.nii.gz,../../DataSet/BraTS2024-BraTS-GLI-TrainingData/BraTS-GLI-02760-100/BraTS-GLI-02760-100-t1n.nii.gz,../../DataSet/BraTS2024-BraTS-GLI-TrainingData/BraTS-GLI-02760-100/BraTS-GLI-02760-100-seg.nii.gz,66,132,106,53,80,103,175,83,130,27,72,47
02145-101,../../DataSet/BraTS2024-BraTS-GLI-TrainingData/BraTS-GLI-02145-101/BraTS-GLI-02145-101-t1c.nii.gz,../../DataSet/BraTS2024-BraTS-GLI-TrainingData/BraTS-GLI-02145-101/BraTS-GLI-02145-101-t2w.nii.gz,../../DataSet/BraTS2024-BraTS-GLI-TrainingData/BraTS-GLI-02145-101/BraTS-GLI-02145-101-t2f.nii.gz,../../DataSet/BraTS2024-BraTS-GLI-TrainingData/BraTS-GLI-02145-101/BraTS-GLI-02145-101-t1n.nii.gz,../../DataSet/BraTS2024-BraTS-GLI-TrainingData/BraTS-GLI-02145-101/BraTS-GLI-02145-101-seg.nii.gz,73,62,106,44,117,36,108,74,141,73,72,67
02987-101,../../DataSet/BraTS2024-BraTS-GLI-TrainingData/BraTS-GLI-02987-101/BraTS-GLI-02987-101-t1c.nii.gz,../../DataSet/BraTS2024-BraTS-GLI-TrainingData/BraTS-GLI-02987-101/BraTS-GLI-02987-101-t2w.nii.gz,../../DataSet/BraTS2024-BraTS-GLI-TrainingData/BraTS-GLI-02987-101/BraTS-GLI-02987-101-t2f.nii.gz,../../DataSet/BraTS2024-BraTS-GLI-TrainingData/BraTS-GLI-02987-101/BraTS-GLI-02987-101-t1n.nii.gz,../../DataSet/BraTS2024-BraTS-GLI-TrainingData/BraTS-GLI-02987-101/BraTS-GLI-02987-101-seg.nii.gz,113,60,108,63,142,24,115,70,145,79,91,75
00485-100,../../DataSet/BraTS2024-BraTS-GLI-TrainingData/BraTS-GLI-00485-100/BraTS-GLI-00485-100-t1c.nii.gz,../../DataSet/BraTS2024-BraTS-GLI-TrainingData/BraTS-GLI-00485-100/BraTS-GLI-00485-100-t2w.nii.gz,../../DataSet/BraTS2024-BraTS-GLI-TrainingData/BraTS-GLI-00485-100/BraTS-GLI-00485-100-t2f.nii.gz,../../DataSet/BraTS2024-BraTS-GLI-TrainingData/BraTS-GLI-00485-100/BraTS-GLI-00485-100-t1n.nii.gz,../../DataSet/BraTS2024-BraTS-GLI-TrainingData/BraTS-GLI-00485-100/BraTS-GLI-00485-100-seg.nii.gz,119,115,79,90,146,87,144,51,103,56,57,52
00507-101,../../DataSet/BraTS2024-BraTS-GLI-TrainingData/BraTS-GLI-00507-101/BraTS-GLI-00507-101-t1c.nii.gz,../../DataSet/BraTS2024-BraTS-GLI-TrainingData/BraTS-GLI-00507-101/BraTS-GLI-00507-101-t2w.nii.gz,../../DataSet/BraTS2024-BraTS-GLI-TrainingData/BraTS-GLI-00507-101/BraTS-GLI-00507-101-t2f.nii.gz,../../DataSet/BraTS2024-BraTS-GLI-TrainingData/BraTS-GLI-00507-101/BraTS-GLI-00507-101-t1n.nii.gz,../../DataSet/BraTS2024-BraTS-GLI-TrainingData/BraTS-GLI-00507-101/BraTS-GLI-00507-101-seg.nii.gz,108,162,108,91,131,120,187,87,132,40,67,45
02288-100,../../DataSet/BraTS2024-BraTS-GLI-TrainingData/BraTS-GLI-02288-100/BraTS-GLI-02288-100-t1c.nii.gz,../../DataSet/BraTS2024-BraTS-GLI-TrainingData/BraTS-GLI-02288-100/BraTS-GLI-02288-100-t2w.nii.gz,../../DataSet/BraTS2024-BraTS-GLI-TrainingData/BraTS-GLI-02288-100/BraTS-GLI-02288-100-t2f.nii.gz,../../DataSet/BraTS2024-BraTS-GLI-TrainingData/BraTS-GLI-02288-100/BraTS-GLI-02288-100-t1n.nii.gz,../../DataSet/BraTS2024-BraTS-GLI-TrainingData/BraTS-GLI-02288-100/BraTS-GLI-02288-100-seg.nii.gz,58,73,78,27,111,38,118,50,106,84,80,56
02638-100,../../DataSet/BraTS2024-BraTS-GLI-TrainingData/BraTS-GLI-02638-100/BraTS-GLI-02638-100-t1c.nii.gz,../../DataSet/BraTS2024-BraTS-GLI-TrainingData/BraTS-GLI-02638-100/BraTS-GLI-02638-100-t2w.nii.gz,../../DataSet/BraTS2024-BraTS-GLI-TrainingData/BraTS-GLI-02638-100/BraTS-GLI-02638-100-t2f.nii.gz,../../DataSet/BraTS2024-BraTS-GLI-TrainingData/BraTS-GLI-02638-100/BraTS-GLI-02638-100-t1n.nii.gz,../../DataSet/BraTS2024-BraTS-GLI-TrainingData/BraTS-GLI-02638-100/BraTS-GLI-02638-100-seg.nii.gz,115,113,82,78,155,74,154,58,112,77,80,54
02558-101,../../DataSet/BraTS2024-BraTS-GLI-TrainingData/BraTS-GLI-02558-101/BraTS-GLI-02558-101-t1c.nii.gz,../../DataSet/BraTS2024-BraTS-GLI-TrainingData/BraTS-GLI-02558-101/BraTS-GLI-02558-101-t2w.nii.gz,../../DataSet/BraTS2024-BraTS-GLI-TrainingData/BraTS-GLI-02558-101/BraTS-GLI-02558-101-t2f.nii.gz,../../DataSet/BraTS2024-BraTS-GLI-TrainingData/BraTS-GLI-02558-101/BraTS-GLI-02558-101-t1n.nii.gz,../../DataSet/BraTS2024-BraTS-GLI-TrainingData/BraTS-GLI-02558-101/BraTS-GLI-02558-101-seg.nii.gz,65,76,73,39,89,36,120,56,102,50,84,46
02083-102,../../DataSet/BraTS2024-BraTS-GLI-TrainingData/BraTS-GLI-02083-102/BraTS-GLI-02083-102-t1c.nii.gz,../../DataSet/BraTS2024-BraTS-GLI-TrainingData/BraTS-GLI-02083-102/BraTS-GLI-02083-102-t2w.nii.gz,../../DataSet/BraTS2024-BraTS-GLI-TrainingData/BraTS-GLI-02083-102/BraTS-GLI-02083-102-t2f.nii.gz,../../DataSet/BraTS2024-BraTS-GLI-TrainingData/BraTS-GLI-02083-102/BraTS-GLI-02083-102-t1n.nii.gz,../../DataSet/BraTS2024-BraTS-GLI-TrainingData/BraTS-GLI-02083-102/BraTS-GLI-02083-102-seg.nii.gz,72,97,131,54,90,57,137,105,159,36,80,54
02879-100,../../DataSet/BraTS2024-BraTS-GLI-TrainingData/BraTS-GLI-02879-100/BraTS-GLI-02879-100-t1c.nii.gz,../../DataSet/BraTS2024-BraTS-GLI-TrainingData/BraTS-GLI-02879-100/BraTS-GLI-02879-100-t2w.nii.gz,../../DataSet/BraTS2024-BraTS-GLI-TrainingData/BraTS-GLI-02879-100/BraTS-GLI-02879-100-t2f.nii.gz,../../DataSet/BraTS2024-BraTS-GLI-TrainingData/BraTS-GLI-02879-100/BraTS-GLI-02879-100-t1n.nii.gz,../../DataSet/BraTS2024-BraTS-GLI-TrainingData/BraTS-GLI-02879-100/BraTS-GLI-02879-100-seg.nii.gz,125,124,100,105,147,99,145,78,133,42,46,55
02216-103,../../DataSet/BraTS2024-BraTS-GLI-TrainingData/BraTS-GLI-02216-103/BraTS-GLI-02216-103-t1c.nii.gz,../../DataSet/BraTS2024-BraTS-GLI-TrainingData/BraTS-GLI-02216-103/BraTS-GLI-02216-103-t2w.nii.gz,../../DataSet/BraTS2024-BraTS-GLI-TrainingData/BraTS-GLI-02216-103/BraTS-GLI-02216-103-t2f.nii.gz,../../DataSet/BraTS2024-BraTS-GLI-TrainingData/BraTS-GLI-02216-103/BraTS-GLI-02216-103-t1n.nii.gz,../../DataSet/BraTS2024-BraTS-GLI-TrainingData/BraTS-GLI-02216-103/BraTS-GLI-02216-103-seg.nii.gz,72,152,117,54,107,122,181,88,144,53,59,56
02092-105,../../DataSet/BraTS2024-BraTS-GLI-TrainingData/BraTS-GLI-02092-105/BraTS-GLI-02092-105-t1c.nii.gz,../../DataSet/BraTS2024-BraTS-GLI-TrainingData/BraTS-GLI-02092-105/BraTS-GLI-02092-105-t2w.nii.gz,../../DataSet/BraTS2024-BraTS-GLI-TrainingData/BraTS-GLI-02092-105/BraTS-GLI-02092-105-t2f.nii.gz,../../DataSet/BraTS2024-BraTS-GLI-TrainingData/BraTS-GLI-02092-105/BraTS-GLI-02092-105-t1n.nii.gz,../../DataSet/BraTS2024-BraTS-GLI-TrainingData/BraTS-GLI-02092-105/BraTS-GLI-02092-105-seg.nii.gz,96,157,100,57,126,108,193,64,137,69,85,73
02061-101,../../DataSet/BraTS2024-BraTS-GLI-TrainingData/BraTS-GLI-02061-101/BraTS-GLI-02061-101-t1c.nii.gz,../../DataSet/BraTS2024-BraTS-GLI-TrainingData/BraTS-GLI-02061-101/BraTS-GLI-02061-101-t2w.nii.gz,../../DataSet/BraTS2024-BraTS-GLI-TrainingData/BraTS-GLI-02061-101/BraTS-GLI-02061-101-t2f.nii.gz,../../DataSet/BraTS2024-BraTS-GLI-TrainingData/BraTS-GLI-02061-101/BraTS-GLI-02061-101-t1n.nii.gz,../../DataSet/BraTS2024-BraTS-GLI-TrainingData/BraTS-GLI-02061-101/BraTS-GLI-02061-101-seg.nii.gz,98,88,128,68,138,58,130,97,152,70,72,55
02989-101,../../DataSet/BraTS2024-BraTS-GLI-TrainingData/BraTS-GLI-02989-101/BraTS-GLI-02989-101-t1c.nii.gz,../../DataSet/BraTS2024-BraTS-GLI-TrainingData/BraTS-GLI-02989-101/BraTS-GLI-02989-101-t2w.nii.gz,../../DataSet/BraTS2024-BraTS-GLI-TrainingData/BraTS-GLI-02989-101/BraTS-GLI-02989-101-t2f.nii.gz,../../DataSet/BraTS2024-BraTS-GLI-TrainingData/BraTS-GLI-02989-101/BraTS-GLI-02989-101-t1n.nii.gz,../../DataSet/BraTS2024-BraTS-GLI-TrainingData/BraTS-GLI-02989-101/BraTS-GLI-02989-101-seg.nii.gz,126,109,85,105,155,68,146,54,115,50,78,61
02178-102,../../DataSet/BraTS2024-BraTS-GLI-TrainingData/BraTS-GLI-02178-102/BraTS-GLI-02178-102-t1c.nii.gz,../../DataSet/BraTS2024-BraTS-GLI-TrainingData/BraTS-GLI-02178-102/BraTS-GLI-02178-102-t2w.nii.gz,../../DataSet/BraTS2024-BraTS-GLI-TrainingData/BraTS-GLI-02178-102/BraTS-GLI-02178-102-t2f.nii.gz,../../DataSet/BraTS2024-BraTS-GLI-TrainingData/BraTS-GLI-02178-102/BraTS-GLI-02178-102-t1n.nii.gz,../../DataSet/BraTS2024-BraTS-GLI-TrainingData/BraTS-GLI-02178-102/BraTS-GLI-02178-102-seg.nii.gz,112,130,119,94,136,80,166,73,149,42,86,76
02765-101,../../DataSet/BraTS2024-BraTS-GLI-TrainingData/BraTS-GLI-02765-101/BraTS-GLI-02765-101-t1c.nii.gz,../../DataSet/BraTS2024-BraTS-GLI-TrainingData/BraTS-GLI-02765-101/BraTS-GLI-02765-101-t2w.nii.gz,../../DataSet/BraTS2024-BraTS-GLI-TrainingData/BraTS-GLI-02765-101/BraTS-GLI-02765-101-t2f.nii.gz,../../DataSet/BraTS2024-BraTS-GLI-TrainingData/BraTS-GLI-02765-101/BraTS-GLI-02765-101-t1n.nii.gz,../../DataSet/BraTS2024-BraTS-GLI-TrainingData/BraTS-GLI-02765-101/BraTS-GLI-02765-101-seg.nii.gz,98,138,103,81,120,105,178,69,136,39,73,67
00008-103,../../DataSet/BraTS2024-BraTS-GLI-TrainingData/BraTS-GLI-00008-103/BraTS-GLI-00008-103-t1c.nii.gz,../../DataSet/BraTS2024-BraTS-GLI-TrainingData/BraTS-GLI-00008-103/BraTS-GLI-00008-103-t2w.nii.gz,../../DataSet/BraTS2024-BraTS-GLI-TrainingData/BraTS-GLI-00008-103/BraTS-GLI-00008-103-t2f.nii.gz,../../DataSet/BraTS2024-BraTS-GLI-TrainingData/BraTS-GLI-00008-103/BraTS-GLI-00008-103-t1n.nii.gz,../../DataSet/BraTS2024-BraTS-GLI-TrainingData/BraTS-GLI-00008-103/BraTS-GLI-00008-103-seg.nii.gz,51,70,76,30,76,39,100,50,99,46,61,49
02953-100,../../DataSet/BraTS2024-BraTS-GLI-TrainingData/BraTS-GLI-02953-100/BraTS-GLI-02953-100-t1c.nii.gz,../../DataSet/BraTS2024-BraTS-GLI-TrainingData/BraTS-GLI-02953-100/BraTS-GLI-02953-100-t2w.nii.gz,../../DataSet/BraTS2024-BraTS-GLI-TrainingData/BraTS-GLI-02953-100/BraTS-GLI-02953-100-t2f.nii.gz,../../DataSet/BraTS2024-BraTS-GLI-TrainingData/BraTS-GLI-02953-100/BraTS-GLI-02953-100-t1n.nii.gz,../../DataSet/BraTS2024-BraTS-GLI-TrainingData/BraTS-GLI-02953-100/BraTS-GLI-02953-100-seg.nii.gz,105,116,138,91,124,88,152,114,160,33,64,46
02800-101,../../DataSet/BraTS2024-BraTS-GLI-TrainingData/BraTS-GLI-02800-101/BraTS-GLI-02800-101-t1c.nii.gz,../../DataSet/BraTS2024-BraTS-GLI-TrainingData/BraTS-GLI-02800-101/BraTS-GLI-02800-101-t2w.nii.gz,../../DataSet/BraTS2024-BraTS-GLI-TrainingData/BraTS-GLI-02800-101/BraTS-GLI-02800-101-t2f.nii.gz,../../DataSet/BraTS2024-BraTS-GLI-TrainingData/BraTS-GLI-02800-101/BraTS-GLI-02800-101-t1n.nii.gz,../../DataSet/BraTS2024-BraTS-GLI-TrainingData/BraTS-GLI-02800-101/BraTS-GLI-02800-101-seg.nii.gz,67,138,98,40,96,102,175,73,130,56,73,57
02982-100,../../DataSet/BraTS2024-BraTS-GLI-TrainingData/BraTS-GLI-02982-100/BraTS-GLI-02982-100-t1c.nii.gz,../../DataSet/BraTS2024-BraTS-GLI-TrainingData/BraTS-GLI-02982-100/BraTS-GLI-02982-100-t2w.nii.gz,../../DataSet/BraTS2024-BraTS-GLI-TrainingData/BraTS-GLI-02982-100/BraTS-GLI-02982-100-t2f.nii.gz,../../DataSet/BraTS2024-BraTS-GLI-TrainingData/BraTS-GLI-02982-100/BraTS-GLI-02982-100-t1n.nii.gz,../../DataSet/BraTS2024-BraTS-GLI-TrainingData/BraTS-GLI-02982-100/BraTS-GLI-02982-100-seg.nii.gz,56,131,73,32,82,104,153,46,107,50,49,61
02636-100,../../DataSet/BraTS2024-BraTS-GLI-TrainingData/BraTS-GLI-02636-100/BraTS-GLI-02636-100-t1c.nii.gz,../../DataSet/BraTS2024-BraTS-GLI-TrainingData/BraTS-GLI-02636-100/BraTS-GLI-02636-100-t2w.nii.gz,../../DataSet/BraTS2024-BraTS-GLI-TrainingData/BraTS-GLI-02636-100/BraTS-GLI-02636-100-t2f.nii.gz,../../DataSet/BraTS2024-BraTS-GLI-TrainingData/BraTS-GLI-02636-100/BraTS-GLI-02636-100-t1n.nii.gz,../../DataSet/BraTS2024-BraTS-GLI-TrainingData/BraTS-GLI-02636-100/BraTS-GLI-02636-100-seg.nii.gz,84,68,49,57,100,42,86,30,66,43,44,36
02191-100,../../DataSet/BraTS2024-BraTS-GLI-TrainingData/BraTS-GLI-02191-100/BraTS-GLI-02191-100-t1c.nii.gz,../../DataSet/BraTS2024-BraTS-GLI-TrainingData/BraTS-GLI-02191-100/BraTS-GLI-02191-100-t2w.nii.gz,../../DataSet/BraTS2024-BraTS-GLI-TrainingData/BraTS-GLI-02191-100/BraTS-GLI-02191-100-t2f.nii.gz,../../DataSet/BraTS2024-BraTS-GLI-TrainingData/BraTS-GLI-02191-100/BraTS-GLI-02191-100-t1n.nii.gz,../../DataSet/BraTS2024-BraTS-GLI-TrainingData/BraTS-GLI-02191-100/BraTS-GLI-02191-100-seg.nii.gz,48,114,64,25,75,57,149,34,119,50,92,85
02556-101,../../DataSet/BraTS2024-BraTS-GLI-TrainingData/BraTS-GLI-02556-101/BraTS-GLI-02556-101-t1c.nii.gz,../../DataSet/BraTS2024-BraTS-GLI-TrainingData/BraTS-GLI-02556-101/BraTS-GLI-02556-101-t2w.nii.gz,../../DataSet/BraTS2024-BraTS-GLI-TrainingData/BraTS-GLI-02556-101/BraTS-GLI-02556-101-t2f.nii.gz,../../DataSet/BraTS2024-BraTS-GLI-TrainingData/BraTS-GLI-02556-101/BraTS-GLI-02556-101-t1n.nii.gz,../../DataSet/BraTS2024-BraTS-GLI-TrainingData/BraTS-GLI-02556-101/BraTS-GLI-02556-101-seg.nii.gz,58,103,82,23,89,64,145,49,117,66,81,68
02137-101,../../DataSet/BraTS2024-BraTS-GLI-TrainingData/BraTS-GLI-02137-101/BraTS-GLI-02137-101-t1c.nii.gz,../../DataSet/BraTS2024-BraTS-GLI-TrainingData/BraTS-GLI-02137-101/BraTS-GLI-02137-101-t2w.nii.gz,../../DataSet/BraTS2024-BraTS-GLI-TrainingData/BraTS-GLI-02137-101/BraTS-GLI-02137-101-t2f.nii.gz,../../DataSet/BraTS2024-BraTS-GLI-TrainingData/BraTS-GLI-02137-101/BraTS-GLI-02137-101-t1n.nii.gz,../../DataSet/BraTS2024-BraTS-GLI-TrainingData/BraTS-GLI-02137-101/BraTS-GLI-02137-101-seg.nii.gz,41,78,93,20,72,47,108,61,133,52,61,72
02877-100,../../DataSet/BraTS2024-BraTS-GLI-TrainingData/BraTS-GLI-02877-100/BraTS-GLI-02877-100-t1c.nii.gz,../../DataSet/BraTS2024-BraTS-GLI-TrainingData/BraTS-GLI-02877-100/BraTS-GLI-02877-100-t2w.nii.gz,../../DataSet/BraTS2024-BraTS-GLI-TrainingData/BraTS-GLI-02877-100/BraTS-GLI-02877-100-t2f.nii.gz,../../DataSet/BraTS2024-BraTS-GLI-TrainingData/BraTS-GLI-02877-100/BraTS-GLI-02877-100-t1n.nii.gz,../../DataSet/BraTS2024-BraTS-GLI-TrainingData/BraTS-GLI-02877-100/BraTS-GLI-02877-100-seg.nii.gz,141,125,99,126,152,113,143,84,114,26,30,30
02220-101,../../DataSet/BraTS2024-BraTS-GLI-TrainingData/BraTS-GLI-02220-101/BraTS-GLI-02220-101-t1c.nii.gz,../../DataSet/BraTS2024-BraTS-GLI-TrainingData/BraTS-GLI-02220-101/BraTS-GLI-02220-101-t2w.nii.gz,../../DataSet/BraTS2024-BraTS-GLI-TrainingData/BraTS-GLI-02220-101/BraTS-GLI-02220-101-t2f.nii.gz,../../DataSet/BraTS2024-BraTS-GLI-TrainingData/BraTS-GLI-02220-101/BraTS-GLI-02220-101-t1n.nii.gz,../../DataSet/BraTS2024-BraTS-GLI-TrainingData/BraTS-GLI-02220-101/BraTS-GLI-02220-101-seg.nii.gz,128,116,110,109,148,96,138,85,141,39,42,56
02218-103,../../DataSet/BraTS2024-BraTS-GLI-TrainingData/BraTS-GLI-02218-103/BraTS-GLI-02218-103-t1c.nii.gz,../../DataSet/BraTS2024-BraTS-GLI-TrainingData/BraTS-GLI-02218-103/BraTS-GLI-02218-103-t2w.nii.gz,../../DataSet/BraTS2024-BraTS-GLI-TrainingData/BraTS-GLI-02218-103/BraTS-GLI-02218-103-t2f.nii.gz,../../DataSet/BraTS2024-BraTS-GLI-TrainingData/BraTS-GLI-02218-103/BraTS-GLI-02218-103-t1n.nii.gz,../../DataSet/BraTS2024-BraTS-GLI-TrainingData/BraTS-GLI-02218-103/BraTS-GLI-02218-103-seg.nii.gz,123,128,78,103,147,99,157,54,106,44,58,52
02209-104,../../DataSet/BraTS2024-BraTS-GLI-TrainingData/BraTS-GLI-02209-104/BraTS-GLI-02209-104-t1c.nii.gz,../../DataSet/BraTS2024-BraTS-GLI-TrainingData/BraTS-GLI-02209-104/BraTS-GLI-02209-104-t2w.nii.gz,../../DataSet/BraTS2024-BraTS-GLI-TrainingData/BraTS-GLI-02209-104/BraTS-GLI-02209-104-t2f.nii.gz,../../DataSet/BraTS2024-BraTS-GLI-TrainingData/BraTS-GLI-02209-104/BraTS-GLI-02209-104-t1n.nii.gz,../../DataSet/BraTS2024-BraTS-GLI-TrainingData/BraTS-GLI-02209-104/BraTS-GLI-02209-104-seg.nii.gz,59,134,97,33,92,92,172,57,141,59,80,84
02378-101,../../DataSet/BraTS2024-BraTS-GLI-TrainingData/BraTS-GLI-02378-101/BraTS-GLI-02378-101-t1c.nii.gz,../../DataSet/BraTS2024-BraTS-GLI-TrainingData/BraTS-GLI-02378-101/BraTS-GLI-02378-101-t2w.nii.gz,../../DataSet/BraTS2024-BraTS-GLI-TrainingData/BraTS-GLI-02378-101/BraTS-GLI-02378-101-t2f.nii.gz,../../DataSet/BraTS2024-BraTS-GLI-TrainingData/BraTS-GLI-02378-101/BraTS-GLI-02378-101-t1n.nii.gz,../../DataSet/BraTS2024-BraTS-GLI-TrainingData/BraTS-GLI-02378-101/BraTS-GLI-02378-101-seg.nii.gz,92,120,124,54,136,81,154,100,152,82,73,52
02923-101,../../DataSet/BraTS2024-BraTS-GLI-TrainingData/BraTS-GLI-02923-101/BraTS-GLI-02923-101-t1c.nii.gz,../../DataSet/BraTS2024-BraTS-GLI-TrainingData/BraTS-GLI-02923-101/BraTS-GLI-02923-101-t2w.nii.gz,../../DataSet/BraTS2024-BraTS-GLI-TrainingData/BraTS-GLI-02923-101/BraTS-GLI-02923-101-t2f.nii.gz,../../DataSet/BraTS2024-BraTS-GLI-TrainingData/BraTS-GLI-02923-101/BraTS-GLI-02923-101-t1n.nii.gz,../../DataSet/BraTS2024-BraTS-GLI-TrainingData/BraTS-GLI-02923-101/BraTS-GLI-02923-101-seg.nii.gz,34,115,100,23,55,83,136,85,121,32,53,36
02205-105,../../DataSet/BraTS2024-BraTS-GLI-TrainingData/BraTS-GLI-02205-105/BraTS-GLI-02205-105-t1c.nii.gz,../../DataSet/BraTS2024-BraTS-GLI-TrainingData/BraTS-GLI-02205-105/BraTS-GLI-02205-105-t2w.nii.gz,../../DataSet/BraTS2024-BraTS-GLI-TrainingData/BraTS-GLI-02205-105/BraTS-GLI-02205-105-t2f.nii.gz,../../DataSet/BraTS2024-BraTS-GLI-TrainingData/BraTS-GLI-02205-105/BraTS-GLI-02205-105-t1n.nii.gz,../../DataSet/BraTS2024-BraTS-GLI-TrainingData/BraTS-GLI-02205-105/BraTS-GLI-02205-105-seg.nii.gz,101,144,116,87,118,111,182,76,150,31,71,74
02063-100,../../DataSet/BraTS2024-BraTS-GLI-TrainingData/BraTS-GLI-02063-100/BraTS-GLI-02063-100-t1c.nii.gz,../../DataSet/BraTS2024-BraTS-GLI-TrainingData/BraTS-GLI-02063-100/BraTS-GLI-02063-100-t2w.nii.gz,../../DataSet/BraTS2024-BraTS-GLI-TrainingData/BraTS-GLI-02063-100/BraTS-GLI-02063-100-t2f.nii.gz,../../DataSet/BraTS2024-BraTS-GLI-TrainingData/BraTS-GLI-02063-100/BraTS-GLI-02063-100-t1n.nii.gz,../../DataSet/BraTS2024-BraTS-GLI-TrainingData/BraTS-GLI-02063-100/BraTS-GLI-02063-100-seg.nii.gz,53,100,111,26,81,65,148,78,153,55,83,75
02227-101,../../DataSet/BraTS2024-BraTS-GLI-TrainingData/BraTS-GLI-02227-101/BraTS-GLI-02227-101-t1c.nii.gz,../../DataSet/BraTS2024-BraTS-GLI-TrainingData/BraTS-GLI-02227-101/BraTS-GLI-02227-101-t2w.nii.gz,../../DataSet/BraTS2024-BraTS-GLI-TrainingData/BraTS-GLI-02227-101/BraTS-GLI-02227-101-t2f.nii.gz,../../DataSet/BraTS2024-BraTS-GLI-TrainingData/BraTS-GLI-02227-101/BraTS-GLI-02227-101-t1n.nii.gz,../../DataSet/BraTS2024-BraTS-GLI-TrainingData/BraTS-GLI-02227-101/BraTS-GLI-02227-101-seg.nii.gz,70,147,115,45,89,107,182,84,147,44,75,63
02928-100,../../DataSet/BraTS2024-BraTS-GLI-TrainingData/BraTS-GLI-02928-100/BraTS-GLI-02928-100-t1c.nii.gz,../../DataSet/BraTS2024-BraTS-GLI-TrainingData/BraTS-GLI-02928-100/BraTS-GLI-02928-100-t2w.nii.gz,../../DataSet/BraTS2024-BraTS-GLI-TrainingData/BraTS-GLI-02928-100/BraTS-GLI-02928-100-t2f.nii.gz,../../DataSet/BraTS2024-BraTS-GLI-TrainingData/BraTS-GLI-02928-100/BraTS-GLI-02928-100-t1n.nii.gz,../../DataSet/BraTS2024-BraTS-GLI-TrainingData/BraTS-GLI-02928-100/BraTS-GLI-02928-100-seg.nii.gz,77,171,99,48,105,136,199,61,136,57,63,75
02068-101,../../DataSet/BraTS2024-BraTS-GLI-TrainingData/BraTS-GLI-02068-101/BraTS-GLI-02068-101-t1c.nii.gz,../../DataSet/BraTS2024-BraTS-GLI-TrainingData/BraTS-GLI-02068-101/BraTS-GLI-02068-101-t2w.nii.gz,../../DataSet/BraTS2024-BraTS-GLI-TrainingData/BraTS-GLI-02068-101/BraTS-GLI-02068-101-t2f.nii.gz,../../DataSet/BraTS2024-BraTS-GLI-TrainingData/BraTS-GLI-02068-101/BraTS-GLI-02068-101-t1n.nii.gz,../../DataSet/BraTS2024-BraTS-GLI-TrainingData/BraTS-GLI-02068-101/BraTS-GLI-02068-101-seg.nii.gz,114,57,96,90,136,25,110,71,122,46,85,51
02769-100,../../DataSet/BraTS2024-BraTS-GLI-TrainingData/BraTS-GLI-02769-100/BraTS-GLI-02769-100-t1c.nii.gz,../../DataSet/BraTS2024-BraTS-GLI-TrainingData/BraTS-GLI-02769-100/BraTS-GLI-02769-100-t2w.nii.gz,../../DataSet/BraTS2024-BraTS-GLI-TrainingData/BraTS-GLI-02769-100/BraTS-GLI-02769-100-t2f.nii.gz,../../DataSet/BraTS2024-BraTS-GLI-TrainingData/BraTS-GLI-02769-100/BraTS-GLI-02769-100-t1n.nii.gz,../../DataSet/BraTS2024-BraTS-GLI-TrainingData/BraTS-GLI-02769-100/BraTS-GLI-02769-100-seg.nii.gz,55,65,104,32,79,33,128,63,141,47,95,78
02147-100,../../DataSet/BraTS2024-BraTS-GLI-TrainingData/BraTS-GLI-02147-100/BraTS-GLI-02147-100-t1c.nii.gz,../../DataSet/BraTS2024-BraTS-GLI-TrainingData/BraTS-GLI-02147-100/BraTS-GLI-02147-100-t2w.nii.gz,../../DataSet/BraTS2024-BraTS-GLI-TrainingData/BraTS-GLI-02147-100/BraTS-GLI-02147-100-t2f.nii.gz,../../DataSet/BraTS2024-BraTS-GLI-TrainingData/BraTS-GLI-02147-100/BraTS-GLI-02147-100-t1n.nii.gz,../../DataSet/BraTS2024-BraTS-GLI-TrainingData/BraTS-GLI-02147-100/BraTS-GLI-02147-100-seg.nii.gz,64,129,124,41,85,98,184,96,154,44,86,58
02954-100,../../DataSet/BraTS2024-BraTS-GLI-TrainingData/BraTS-GLI-02954-100/BraTS-GLI-02954-100-t1c.nii.gz,../../DataSet/BraTS2024-BraTS-GLI-TrainingData/BraTS-GLI-02954-100/BraTS-GLI-02954-100-t2w.nii.gz,../../DataSet/BraTS2024-BraTS-GLI-TrainingData/BraTS-GLI-02954-100/BraTS-GLI-02954-100-t2f.nii.gz,../../DataSet/BraTS2024-BraTS-GLI-TrainingData/BraTS-GLI-02954-100/BraTS-GLI-02954-100-t1n.nii.gz,../../DataSet/BraTS2024-BraTS-GLI-TrainingData/BraTS-GLI-02954-100/BraTS-GLI-02954-100-seg.nii.gz,77,144,109,65,90,125,160,94,132,25,35,38
02281-100,../../DataSet/BraTS2024-BraTS-GLI-TrainingData/BraTS-GLI-02281-100/BraTS-GLI-02281-100-t1c.nii.gz,../../DataSet/BraTS2024-BraTS-GLI-TrainingData/BraTS-GLI-02281-100/BraTS-GLI-02281-100-t2w.nii.gz,../../DataSet/BraTS2024-BraTS-GLI-TrainingData/BraTS-GLI-02281-100/BraTS-GLI-02281-100-t2f.nii.gz,../../DataSet/BraTS2024-BraTS-GLI-TrainingData/BraTS-GLI-02281-100/BraTS-GLI-02281-100-t1n.nii.gz,../../DataSet/BraTS2024-BraTS-GLI-TrainingData/BraTS-GLI-02281-100/BraTS-GLI-02281-100-seg.nii.gz,137,112,63,115,159,81,144,46,84,44,63,38
00505-100,../../DataSet/BraTS2024-BraTS-GLI-TrainingData/BraTS-GLI-00505-100/BraTS-GLI-00505-100-t1c.nii.gz,../../DataSet/BraTS2024-BraTS-GLI-TrainingData/BraTS-GLI-00505-100/BraTS-GLI-00505-100-t2w.nii.gz,../../DataSet/BraTS2024-BraTS-GLI-TrainingData/BraTS-GLI-00505-100/BraTS-GLI-00505-100-t2f.nii.gz,../../DataSet/BraTS2024-BraTS-GLI-TrainingData/BraTS-GLI-00505-100/BraTS-GLI-00505-100-t1n.nii.gz,../../DataSet/BraTS2024-BraTS-GLI-TrainingData/BraTS-GLI-00505-100/BraTS-GLI-00505-100-seg.nii.gz,130,77,93,101,154,37,116,67,131,53,79,64
02985-100,../../DataSet/BraTS2024-BraTS-GLI-TrainingData/BraTS-GLI-02985-100/BraTS-GLI-02985-100-t1c.nii.gz,../../DataSet/BraTS2024-BraTS-GLI-TrainingData/BraTS-GLI-02985-100/BraTS-GLI-02985-100-t2w.nii.gz,../../DataSet/BraTS2024-BraTS-GLI-TrainingData/BraTS-GLI-02985-100/BraTS-GLI-02985-100-t2f.nii.gz,../../DataSet/BraTS2024-BraTS-GLI-TrainingData/BraTS-GLI-02985-100/BraTS-GLI-02985-100-t1n.nii.gz,../../DataSet/BraTS2024-BraTS-GLI-TrainingData/BraTS-GLI-02985-100/BraTS-GLI-02985-100-seg.nii.gz,77,150,105,62,93,116,182,75,131,31,66,56
02196-100,../../DataSet/BraTS2024-BraTS-GLI-TrainingData/BraTS-GLI-02196-100/BraTS-GLI-02196-100-t1c.nii.gz,../../DataSet/BraTS2024-BraTS-GLI-TrainingData/BraTS-GLI-02196-100/BraTS-GLI-02196-100-t2w.nii.gz,../../DataSet/BraTS2024-BraTS-GLI-TrainingData/BraTS-GLI-02196-100/BraTS-GLI-02196-100-t2f.nii.gz,../../DataSet/BraTS2024-BraTS-GLI-TrainingData/BraTS-GLI-02196-100/BraTS-GLI-02196-100-t1n.nii.gz,../../DataSet/BraTS2024-BraTS-GLI-TrainingData/BraTS-GLI-02196-100/BraTS-GLI-02196-100-seg.nii.gz,76,155,100,46,121,106,192,59,139,75,86,80
02631-100,../../DataSet/BraTS2024-BraTS-GLI-TrainingData/BraTS-GLI-02631-100/BraTS-GLI-02631-100-t1c.nii.gz,../../DataSet/BraTS2024-BraTS-GLI-TrainingData/BraTS-GLI-02631-100/BraTS-GLI-02631-100-t2w.nii.gz,../../DataSet/BraTS2024-BraTS-GLI-TrainingData/BraTS-GLI-02631-100/BraTS-GLI-02631-100-t2f.nii.gz,../../DataSet/BraTS2024-BraTS-GLI-TrainingData/BraTS-GLI-02631-100/BraTS-GLI-02631-100-t1n.nii.gz,../../DataSet/BraTS2024-BraTS-GLI-TrainingData/BraTS-GLI-02631-100/BraTS-GLI-02631-100-seg.nii.gz,64,119,99,44,91,76,157,81,118,47,81,37
02845-100,../../DataSet/BraTS2024-BraTS-GLI-TrainingData/BraTS-GLI-02845-100/BraTS-GLI-02845-100-t1c.nii.gz,../../DataSet/BraTS2024-BraTS-GLI-TrainingData/BraTS-GLI-02845-100/BraTS-GLI-02845-100-t2w.nii.gz,../../DataSet/BraTS2024-BraTS-GLI-TrainingData/BraTS-GLI-02845-100/BraTS-GLI-02845-100-t2f.nii.gz,../../DataSet/BraTS2024-BraTS-GLI-TrainingData/BraTS-GLI-02845-100/BraTS-GLI-02845-100-t1n.nii.gz,../../DataSet/BraTS2024-BraTS-GLI-TrainingData/BraTS-GLI-02845-100/BraTS-GLI-02845-100-seg.nii.gz,111,93,104,99,131,61,129,88,129,32,68,41
02390-100,../../DataSet/BraTS2024-BraTS-GLI-TrainingData/BraTS-GLI-02390-100/BraTS-GLI-02390-100-t1c.nii.gz,../../DataSet/BraTS2024-BraTS-GLI-TrainingData/BraTS-GLI-02390-100/BraTS-GLI-02390-100-t2w.nii.gz,../../DataSet/BraTS2024-BraTS-GLI-TrainingData/BraTS-GLI-02390-100/BraTS-GLI-02390-100-t2f.nii.gz,../../DataSet/BraTS2024-BraTS-GLI-TrainingData/BraTS-GLI-02390-100/BraTS-GLI-02390-100-t1n.nii.gz,../../DataSet/BraTS2024-BraTS-GLI-TrainingData/BraTS-GLI-02390-100/BraTS-GLI-02390-100-seg.nii.gz,47,73,99,32,72,56,105,80,119,40,49,39
02720-100,../../DataSet/BraTS2024-BraTS-GLI-TrainingData/BraTS-GLI-02720-100/BraTS-GLI-02720-100-t1c.nii.gz,../../DataSet/BraTS2024-BraTS-GLI-TrainingData/BraTS-GLI-02720-100/BraTS-GLI-02720-100-t2w.nii.gz,../../DataSet/BraTS2024-BraTS-GLI-TrainingData/BraTS-GLI-02720-100/BraTS-GLI-02720-100-t2f.nii.gz,../../DataSet/BraTS2024-BraTS-GLI-TrainingData/BraTS-GLI-02720-100/BraTS-GLI-02720-100-t1n.nii.gz,../../DataSet/BraTS2024-BraTS-GLI-TrainingData/BraTS-GLI-02720-100/BraTS-GLI-02720-100-seg.nii.gz,118,177,62,95,142,151,199,50,79,47,48,29
02105-101,../../DataSet/BraTS2024-BraTS-GLI-TrainingData/BraTS-GLI-02105-101/BraTS-GLI-02105-101-t1c.nii.gz,../../DataSet/BraTS2024-BraTS-GLI-TrainingData/BraTS-GLI-02105-101/BraTS-GLI-02105-101-t2w.nii.gz,../../DataSet/BraTS2024-BraTS-GLI-TrainingData/BraTS-GLI-02105-101/BraTS-GLI-02105-101-t2f.nii.gz,../../DataSet/BraTS2024-BraTS-GLI-TrainingData/BraTS-GLI-02105-101/BraTS-GLI-02105-101-t1n.nii.gz,../../DataSet/BraTS2024-BraTS-GLI-TrainingData/BraTS-GLI-02105-101/BraTS-GLI-02105-101-seg.nii.gz,77,81,133,57,90,61,100,113,152,33,39,39
02894-100,../../DataSet/BraTS2024-BraTS-GLI-TrainingData/BraTS-GLI-02894-100/BraTS-GLI-02894-100-t1c.nii.gz,../../DataSet/BraTS2024-BraTS-GLI-TrainingData/BraTS-GLI-02894-100/BraTS-GLI-02894-100-t2w.nii.gz,../../DataSet/BraTS2024-BraTS-GLI-TrainingData/BraTS-GLI-02894-100/BraTS-GLI-02894-100-t2f.nii.gz,../../DataSet/BraTS2024-BraTS-GLI-TrainingData/BraTS-GLI-02894-100/BraTS-GLI-02894-100-t1n.nii.gz,../../DataSet/BraTS2024-BraTS-GLI-TrainingData/BraTS-GLI-02894-100/BraTS-GLI-02894-100-seg.nii.gz,117,117,121,93,141,77,163,92,146,48,86,54
02341-100,../../DataSet/BraTS2024-BraTS-GLI-TrainingData/BraTS-GLI-02341-100/BraTS-GLI-02341-100-t1c.nii.gz,../../DataSet/BraTS2024-BraTS-GLI-TrainingData/BraTS-GLI-02341-100/BraTS-GLI-02341-100-t2w.nii.gz,../../DataSet/BraTS2024-BraTS-GLI-TrainingData/BraTS-GLI-02341-100/BraTS-GLI-02341-100-t2f.nii.gz,../../DataSet/BraTS2024-BraTS-GLI-TrainingData/BraTS-GLI-02341-100/BraTS-GLI-02341-100-t1n.nii.gz,../../DataSet/BraTS2024-BraTS-GLI-TrainingData/BraTS-GLI-02341-100/BraTS-GLI-02341-100-seg.nii.gz,112,92,83,79,145,54,134,52,116,66,80,64
02916-101,../../DataSet/BraTS2024-BraTS-GLI-TrainingData/BraTS-GLI-02916-101/BraTS-GLI-02916-101-t1c.nii.gz,../../DataSet/BraTS2024-BraTS-GLI-TrainingData/BraTS-GLI-02916-101/BraTS-GLI-02916-101-t2w.nii.gz,../../DataSet/BraTS2024-BraTS-GLI-TrainingData/BraTS-GLI-02916-101/BraTS-GLI-02916-101-t2f.nii.gz,../../DataSet/BraTS2024-BraTS-GLI-TrainingData/BraTS-GLI-02916-101/BraTS-GLI-02916-101-t1n.nii.gz,../../DataSet/BraTS2024-BraTS-GLI-TrainingData/BraTS-GLI-02916-101/BraTS-GLI-02916-101-seg.nii.gz,67,145,120,42,112,112,177,82,145,70,65,63
02219-100,../../DataSet/BraTS2024-BraTS-GLI-TrainingData/BraTS-GLI-02219-100/BraTS-GLI-02219-100-t1c.nii.gz,../../DataSet/BraTS2024-BraTS-GLI-TrainingData/BraTS-GLI-02219-100/BraTS-GLI-02219-100-t2w.nii.gz,../../DataSet/BraTS2024-BraTS-GLI-TrainingData/BraTS-GLI-02219-100/BraTS-GLI-02219-100-t2f.nii.gz,../../DataSet/BraTS2024-BraTS-GLI-TrainingData/BraTS-GLI-02219-100/BraTS-GLI-02219-100-t1n.nii.gz,../../DataSet/BraTS2024-BraTS-GLI-TrainingData/BraTS-GLI-02219-100/BraTS-GLI-02219-100-seg.nii.gz,55,116,116,39,68,95,132,97,140,29,37,43
02136-102,../../DataSet/BraTS2024-BraTS-GLI-TrainingData/BraTS-GLI-02136-102/BraTS-GLI-02136-102-t1c.nii.gz,../../DataSet/BraTS2024-BraTS-GLI-TrainingData/BraTS-GLI-02136-102/BraTS-GLI-02136-102-t2w.nii.gz,../../DataSet/BraTS2024-BraTS-GLI-TrainingData/BraTS-GLI-02136-102/BraTS-GLI-02136-102-t2f.nii.gz,../../DataSet/BraTS2024-BraTS-GLI-TrainingData/BraTS-GLI-02136-102/BraTS-GLI-02136-102-t1n.nii.gz,../../DataSet/BraTS2024-BraTS-GLI-TrainingData/BraTS-GLI-02136-102/BraTS-GLI-02136-102-seg.nii.gz,58,133,101,33,88,112,154,67,145,55,42,78
02839-100,../../DataSet/BraTS2024-BraTS-GLI-TrainingData/BraTS-GLI-02839-100/BraTS-GLI-02839-100-t1c.nii.gz,../../DataSet/BraTS2024-BraTS-GLI-TrainingData/BraTS-GLI-02839-100/BraTS-GLI-02839-100-t2w.nii.gz,../../DataSet/BraTS2024-BraTS-GLI-TrainingData/BraTS-GLI-02839-100/BraTS-GLI-02839-100-t2f.nii.gz,../../DataSet/BraTS2024-BraTS-GLI-TrainingData/BraTS-GLI-02839-100/BraTS-GLI-02839-100-t1n.nii.gz,../../DataSet/BraTS2024-BraTS-GLI-TrainingData/BraTS-GLI-02839-100/BraTS-GLI-02839-100-seg.nii.gz,121,108,124,103,146,95,122,106,145,43,27,39
02518-101,../../DataSet/BraTS2024-BraTS-GLI-TrainingData/BraTS-GLI-02518-101/BraTS-GLI-02518-101-t1c.nii.gz,../../DataSet/BraTS2024-BraTS-GLI-TrainingData/BraTS-GLI-02518-101/BraTS-GLI-02518-101-t2w.nii.gz,../../DataSet/BraTS2024-BraTS-GLI-TrainingData/BraTS-GLI-02518-101/BraTS-GLI-02518-101-t2f.nii.gz,../../DataSet/BraTS2024-BraTS-GLI-TrainingData/BraTS-GLI-02518-101/BraTS-GLI-02518-101-t1n.nii.gz,../../DataSet/BraTS2024-BraTS-GLI-TrainingData/BraTS-GLI-02518-101/BraTS-GLI-02518-101-seg.nii.gz,116,86,91,79,146,48,143,60,127,67,95,67
02786-101,../../DataSet/BraTS2024-BraTS-GLI-TrainingData/BraTS-GLI-02786-101/BraTS-GLI-02786-101-t1c.nii.gz,../../DataSet/BraTS2024-BraTS-GLI-TrainingData/BraTS-GLI-02786-101/BraTS-GLI-02786-101-t2w.nii.gz,../../DataSet/BraTS2024-BraTS-GLI-TrainingData/BraTS-GLI-02786-101/BraTS-GLI-02786-101-t2f.nii.gz,../../DataSet/BraTS2024-BraTS-GLI-TrainingData/BraTS-GLI-02786-101/BraTS-GLI-02786-101-t1n.nii.gz,../../DataSet/BraTS2024-BraTS-GLI-TrainingData/BraTS-GLI-02786-101/BraTS-GLI-02786-101-seg.nii.gz,50,115,56,27,76,69,151,32,83,49,82,51
00463-101,../../DataSet/BraTS2024-BraTS-GLI-TrainingData/BraTS-GLI-00463-101/BraTS-GLI-00463-101-t1c.nii.gz,../../DataSet/BraTS2024-BraTS-GLI-TrainingData/BraTS-GLI-00463-101/BraTS-GLI-00463-101-t2w.nii.gz,../../DataSet/BraTS2024-BraTS-GLI-TrainingData/BraTS-GLI-00463-101/BraTS-GLI-00463-101-t2f.nii.gz,../../DataSet/BraTS2024-BraTS-GLI-TrainingData/BraTS-GLI-00463-101/BraTS-GLI-00463-101-t1n.nii.gz,../../DataSet/BraTS2024-BraTS-GLI-TrainingData/BraTS-GLI-00463-101/BraTS-GLI-00463-101-seg.nii.gz,136,90,90,114,158,58,127,63,119,44,69,56
02757-101,../../DataSet/BraTS2024-BraTS-GLI-TrainingData/BraTS-GLI-02757-101/BraTS-GLI-02757-101-t1c.nii.gz,../../DataSet/BraTS2024-BraTS-GLI-TrainingData/BraTS-GLI-02757-101/BraTS-GLI-02757-101-t2w.nii.gz,../../DataSet/BraTS2024-BraTS-GLI-TrainingData/BraTS-GLI-02757-101/BraTS-GLI-02757-101-t2f.nii.gz,../../DataSet/BraTS2024-BraTS-GLI-TrainingData/BraTS-GLI-02757-101/BraTS-GLI-02757-101-t1n.nii.gz,../../DataSet/BraTS2024-BraTS-GLI-TrainingData/BraTS-GLI-02757-101/BraTS-GLI-02757-101-seg.nii.gz,65,66,108,37,101,29,102,65,139,64,73,74
02172-100,../../DataSet/BraTS2024-BraTS-GLI-TrainingData/BraTS-GLI-02172-100/BraTS-GLI-02172-100-t1c.nii.gz,../../DataSet/BraTS2024-BraTS-GLI-TrainingData/BraTS-GLI-02172-100/BraTS-GLI-02172-100-t2w.nii.gz,../../DataSet/BraTS2024-BraTS-GLI-TrainingData/BraTS-GLI-02172-100/BraTS-GLI-02172-100-t2f.nii.gz,../../DataSet/BraTS2024-BraTS-GLI-TrainingData/BraTS-GLI-02172-100/BraTS-GLI-02172-100-t1n.nii.gz,../../DataSet/BraTS2024-BraTS-GLI-TrainingData/BraTS-GLI-02172-100/BraTS-GLI-02172-100-seg.nii.gz,48,112,61,29,74,65,151,33,117,45,86,84
02247-104,../../DataSet/BraTS2024-BraTS-GLI-TrainingData/BraTS-GLI-02247-104/BraTS-GLI-02247-104-t1c.nii.gz,../../DataSet/BraTS2024-BraTS-GLI-TrainingData/BraTS-GLI-02247-104/BraTS-GLI-02247-104-t2w.nii.gz,../../DataSet/BraTS2024-BraTS-GLI-TrainingData/BraTS-GLI-02247-104/BraTS-GLI-02247-104-t2f.nii.gz,../../DataSet/BraTS2024-BraTS-GLI-TrainingData/BraTS-GLI-02247-104/BraTS-GLI-02247-104-t1n.nii.gz,../../DataSet/BraTS2024-BraTS-GLI-TrainingData/BraTS-GLI-02247-104/BraTS-GLI-02247-104-seg.nii.gz,52,117,110,32,79,66,155,80,141,47,89,61
02269-101,../../DataSet/BraTS2024-BraTS-GLI-TrainingData/BraTS-GLI-02269-101/BraTS-GLI-02269-101-t1c.nii.gz,../../DataSet/BraTS2024-BraTS-GLI-TrainingData/BraTS-GLI-02269-101/BraTS-GLI-02269-101-t2w.nii.gz,../../DataSet/BraTS2024-BraTS-GLI-TrainingData/BraTS-GLI-02269-101/BraTS-GLI-02269-101-t2f.nii.gz,../../DataSet/BraTS2024-BraTS-GLI-TrainingData/BraTS-GLI-02269-101/BraTS-GLI-02269-101-t1n.nii.gz,../../DataSet/BraTS2024-BraTS-GLI-TrainingData/BraTS-GLI-02269-101/BraTS-GLI-02269-101-seg.nii.gz,121,120,75,84,150,63,159,52,105,66,96,53
02146-103,../../DataSet/BraTS2024-BraTS-GLI-TrainingData/BraTS-GLI-02146-103/BraTS-GLI-02146-103-t1c.nii.gz,../../DataSet/BraTS2024-BraTS-GLI-TrainingData/BraTS-GLI-02146-103/BraTS-GLI-02146-103-t2w.nii.gz,../../DataSet/BraTS2024-BraTS-GLI-TrainingData/BraTS-GLI-02146-103/BraTS-GLI-02146-103-t2f.nii.gz,../../DataSet/BraTS2024-BraTS-GLI-TrainingData/BraTS-GLI-02146-103/BraTS-GLI-02146-103-t1n.nii.gz,../../DataSet/BraTS2024-BraTS-GLI-TrainingData/BraTS-GLI-02146-103/BraTS-GLI-02146-103-seg.nii.gz,128,69,75,109,144,38,98,53,103,35,60,50
02781-101,../../DataSet/BraTS2024-BraTS-GLI-TrainingData/BraTS-GLI-02781-101/BraTS-GLI-02781-101-t1c.nii.gz,../../DataSet/BraTS2024-BraTS-GLI-TrainingData/BraTS-GLI-02781-101/BraTS-GLI-02781-101-t2w.nii.gz,../../DataSet/BraTS2024-BraTS-GLI-TrainingData/BraTS-GLI-02781-101/BraTS-GLI-02781-101-t2f.nii.gz,../../DataSet/BraTS2024-BraTS-GLI-TrainingData/BraTS-GLI-02781-101/BraTS-GLI-02781-101-t1n.nii.gz,../../DataSet/BraTS2024-BraTS-GLI-TrainingData/BraTS-GLI-02781-101/BraTS-GLI-02781-101-seg.nii.gz,64,102,124,43,82,55,149,98,153,39,94,55
02835-101,../../DataSet/BraTS2024-BraTS-GLI-TrainingData/BraTS-GLI-02835-101/BraTS-GLI-02835-101-t1c.nii.gz,../../DataSet/BraTS2024-BraTS-GLI-TrainingData/BraTS-GLI-02835-101/BraTS-GLI-02835-101-t2w.nii.gz,../../DataSet/BraTS2024-BraTS-GLI-TrainingData/BraTS-GLI-02835-101/BraTS-GLI-02835-101-t2f.nii.gz,../../DataSet/BraTS2024-BraTS-GLI-TrainingData/BraTS-GLI-02835-101/BraTS-GLI-02835-101-t1n.nii.gz,../../DataSet/BraTS2024-BraTS-GLI-TrainingData/BraTS-GLI-02835-101/BraTS-GLI-02835-101-seg.nii.gz,51,97,116,30,80,67,130,93,143,50,63,50
02514-100,../../DataSet/BraTS2024-BraTS-GLI-TrainingData/BraTS-GLI-02514-100/BraTS-GLI-02514-100-t1c.nii.gz,../../DataSet/BraTS2024-BraTS-GLI-TrainingData/BraTS-GLI-02514-100/BraTS-GLI-02514-100-t2w.nii.gz,../../DataSet/BraTS2024-BraTS-GLI-TrainingData/BraTS-GLI-02514-100/BraTS-GLI-02514-100-t2f.nii.gz,../../DataSet/BraTS2024-BraTS-GLI-TrainingData/BraTS-GLI-02514-100/BraTS-GLI-02514-100-t1n.nii.gz,../../DataSet/BraTS2024-BraTS-GLI-TrainingData/BraTS-GLI-02514-100/BraTS-GLI-02514-100-seg.nii.gz,59,107,82,32,92,68,148,49,120,60,80,71
02750-101,../../DataSet/BraTS2024-BraTS-GLI-TrainingData/BraTS-GLI-02750-101/BraTS-GLI-02750-101-t1c.nii.gz,../../DataSet/BraTS2024-BraTS-GLI-TrainingData/BraTS-GLI-02750-101/BraTS-GLI-02750-101-t2w.nii.gz,../../DataSet/BraTS2024-BraTS-GLI-TrainingData/BraTS-GLI-02750-101/BraTS-GLI-02750-101-t2f.nii.gz,../../DataSet/BraTS2024-BraTS-GLI-TrainingData/BraTS-GLI-02750-101/BraTS-GLI-02750-101-t1n.nii.gz,../../DataSet/BraTS2024-BraTS-GLI-TrainingData/BraTS-GLI-02750-101/BraTS-GLI-02750-101-seg.nii.gz,124,62,40,102,140,45,86,26,53,38,41,27
02175-100,../../DataSet/BraTS2024-BraTS-GLI-TrainingData/BraTS-GLI-02175-100/BraTS-GLI-02175-100-t1c.nii.gz,../../DataSet/BraTS2024-BraTS-GLI-TrainingData/BraTS-GLI-02175-100/BraTS-GLI-02175-100-t2w.nii.gz,../../DataSet/BraTS2024-BraTS-GLI-TrainingData/BraTS-GLI-02175-100/BraTS-GLI-02175-100-t2f.nii.gz,../../DataSet/BraTS2024-BraTS-GLI-TrainingData/BraTS-GLI-02175-100/BraTS-GLI-02175-100-t1n.nii.gz,../../DataSet/BraTS2024-BraTS-GLI-TrainingData/BraTS-GLI-02175-100/BraTS-GLI-02175-100-seg.nii.gz,131,78,86,103,155,42,112,55,126,52,70,71
02215-101,../../DataSet/BraTS2024-BraTS-GLI-TrainingData/BraTS-GLI-02215-101/BraTS-GLI-02215-101-t1c.nii.gz,../../DataSet/BraTS2024-BraTS-GLI-TrainingData/BraTS-GLI-02215-101/BraTS-GLI-02215-101-t2w.nii.gz,../../DataSet/BraTS2024-BraTS-GLI-TrainingData/BraTS-GLI-02215-101/BraTS-GLI-02215-101-t2f.nii.gz,../../DataSet/BraTS2024-BraTS-GLI-TrainingData/BraTS-GLI-02215-101/BraTS-GLI-02215-101-t1n.nii.gz,../../DataSet/BraTS2024-BraTS-GLI-TrainingData/BraTS-GLI-02215-101/BraTS-GLI-02215-101-seg.nii.gz,127,84,106,104,154,60,120,81,128,50,60,47
02346-100,../../DataSet/BraTS2024-BraTS-GLI-TrainingData/BraTS-GLI-02346-100/BraTS-GLI-02346-100-t1c.nii.gz,../../DataSet/BraTS2024-BraTS-GLI-TrainingData/BraTS-GLI-02346-100/BraTS-GLI-02346-100-t2w.nii.gz,../../DataSet/BraTS2024-BraTS-GLI-TrainingData/BraTS-GLI-02346-100/BraTS-GLI-02346-100-t2f.nii.gz,../../DataSet/BraTS2024-BraTS-GLI-TrainingData/BraTS-GLI-02346-100/BraTS-GLI-02346-100-t1n.nii.gz,../../DataSet/BraTS2024-BraTS-GLI-TrainingData/BraTS-GLI-02346-100/BraTS-GLI-02346-100-seg.nii.gz,42,120,68,28,60,95,149,50,90,32,54,40
02911-101,../../DataSet/BraTS2024-BraTS-GLI-TrainingData/BraTS-GLI-02911-101/BraTS-GLI-02911-101-t1c.nii.gz,../../DataSet/BraTS2024-BraTS-GLI-TrainingData/BraTS-GLI-02911-101/BraTS-GLI-02911-101-t2w.nii.gz,../../DataSet/BraTS2024-BraTS-GLI-TrainingData/BraTS-GLI-02911-101/BraTS-GLI-02911-101-t2f.nii.gz,../../DataSet/BraTS2024-BraTS-GLI-TrainingData/BraTS-GLI-02911-101/BraTS-GLI-02911-101-t1n.nii.gz,../../DataSet/BraTS2024-BraTS-GLI-TrainingData/BraTS-GLI-02911-101/BraTS-GLI-02911-101-seg.nii.gz,127,57,95,106,149,28,92,66,123,43,64,57
02893-100,../../DataSet/BraTS2024-BraTS-GLI-TrainingData/BraTS-GLI-02893-100/BraTS-GLI-02893-100-t1c.nii.gz,../../DataSet/BraTS2024-BraTS-GLI-TrainingData/BraTS-GLI-02893-100/BraTS-GLI-02893-100-t2w.nii.gz,../../DataSet/BraTS2024-BraTS-GLI-TrainingData/BraTS-GLI-02893-100/BraTS-GLI-02893-100-t2f.nii.gz,../../DataSet/BraTS2024-BraTS-GLI-TrainingData/BraTS-GLI-02893-100/BraTS-GLI-02893-100-t1n.nii.gz,../../DataSet/BraTS2024-BraTS-GLI-TrainingData/BraTS-GLI-02893-100/BraTS-GLI-02893-100-seg.nii.gz,125,93,108,100,157,51,131,74,136,57,80,62
02062-103,../../DataSet/BraTS2024-BraTS-GLI-TrainingData/BraTS-GLI-02062-103/BraTS-GLI-02062-103-t1c.nii.gz,../../DataSet/BraTS2024-BraTS-GLI-TrainingData/BraTS-GLI-02062-103/BraTS-GLI-02062-103-t2w.nii.gz,../../DataSet/BraTS2024-BraTS-GLI-TrainingData/BraTS-GLI-02062-103/BraTS-GLI-02062-103-t2f.nii.gz,../../DataSet/BraTS2024-BraTS-GLI-TrainingData/BraTS-GLI-02062-103/BraTS-GLI-02062-103-t1n.nii.gz,../../DataSet/BraTS2024-BraTS-GLI-TrainingData/BraTS-GLI-02062-103/BraTS-GLI-02062-103-seg.nii.gz,51,88,95,29,79,42,128,53,128,50,86,75
02849-101,../../DataSet/BraTS2024-BraTS-GLI-TrainingData/BraTS-GLI-02849-101/BraTS-GLI-02849-101-t1c.nii.gz,../../DataSet/BraTS2024-BraTS-GLI-TrainingData/BraTS-GLI-02849-101/BraTS-GLI-02849-101-t2w.nii.gz,../../DataSet/BraTS2024-BraTS-GLI-TrainingData/BraTS-GLI-02849-101/BraTS-GLI-02849-101-t2f.nii.gz,../../DataSet/BraTS2024-BraTS-GLI-TrainingData/BraTS-GLI-02849-101/BraTS-GLI-02849-101-t1n.nii.gz,../../DataSet/BraTS2024-BraTS-GLI-TrainingData/BraTS-GLI-02849-101/BraTS-GLI-02849-101-seg.nii.gz,56,149,77,29,81,97,192,45,109,52,95,64
02131-102,../../DataSet/BraTS2024-BraTS-GLI-TrainingData/BraTS-GLI-02131-102/BraTS-GLI-02131-102-t1c.nii.gz,../../DataSet/BraTS2024-BraTS-GLI-TrainingData/BraTS-GLI-02131-102/BraTS-GLI-02131-102-t2w.nii.gz,../../DataSet/BraTS2024-BraTS-GLI-TrainingData/BraTS-GLI-02131-102/BraTS-GLI-02131-102-t2f.nii.gz,../../DataSet/BraTS2024-BraTS-GLI-TrainingData/BraTS-GLI-02131-102/BraTS-GLI-02131-102-t1n.nii.gz,../../DataSet/BraTS2024-BraTS-GLI-TrainingData/BraTS-GLI-02131-102/BraTS-GLI-02131-102-seg.nii.gz,48,97,59,28,79,72,127,39,82,51,55,43
02830-100,../../DataSet/BraTS2024-BraTS-GLI-TrainingData/BraTS-GLI-02830-100/BraTS-GLI-02830-100-t1c.nii.gz,../../DataSet/BraTS2024-BraTS-GLI-TrainingData/BraTS-GLI-02830-100/BraTS-GLI-02830-100-t2w.nii.gz,../../DataSet/BraTS2024-BraTS-GLI-TrainingData/BraTS-GLI-02830-100/BraTS-GLI-02830-100-t2f.nii.gz,../../DataSet/BraTS2024-BraTS-GLI-TrainingData/BraTS-GLI-02830-100/BraTS-GLI-02830-100-t1n.nii.gz,../../DataSet/BraTS2024-BraTS-GLI-TrainingData/BraTS-GLI-02830-100/BraTS-GLI-02830-100-seg.nii.gz,70,147,121,48,87,108,191,93,151,39,83,58
02267-101,../../DataSet/BraTS2024-BraTS-GLI-TrainingData/BraTS-GLI-02267-101/BraTS-GLI-02267-101-t1c.nii.gz,../../DataSet/BraTS2024-BraTS-GLI-TrainingData/BraTS-GLI-02267-101/BraTS-GLI-02267-101-t2w.nii.gz,../../DataSet/BraTS2024-BraTS-GLI-TrainingData/BraTS-GLI-02267-101/BraTS-GLI-02267-101-t2f.nii.gz,../../DataSet/BraTS2024-BraTS-GLI-TrainingData/BraTS-GLI-02267-101/BraTS-GLI-02267-101-t1n.nii.gz,../../DataSet/BraTS2024-BraTS-GLI-TrainingData/BraTS-GLI-02267-101/BraTS-GLI-02267-101-seg.nii.gz,119,129,107,72,147,89,167,60,140,75,78,80
02199-103,../../DataSet/BraTS2024-BraTS-GLI-TrainingData/BraTS-GLI-02199-103/BraTS-GLI-02199-103-t1c.nii.gz,../../DataSet/BraTS2024-BraTS-GLI-TrainingData/BraTS-GLI-02199-103/BraTS-GLI-02199-103-t2w.nii.gz,../../DataSet/BraTS2024-BraTS-GLI-TrainingData/BraTS-GLI-02199-103/BraTS-GLI-02199-103-t2f.nii.gz,../../DataSet/BraTS2024-BraTS-GLI-TrainingData/BraTS-GLI-02199-103/BraTS-GLI-02199-103-t1n.nii.gz,../../DataSet/BraTS2024-BraTS-GLI-TrainingData/BraTS-GLI-02199-103/BraTS-GLI-02199-103-seg.nii.gz,103,162,99,72,125,109,186,70,136,53,77,66
02170-101,../../DataSet/BraTS2024-BraTS-GLI-TrainingData/BraTS-GLI-02170-101/BraTS-GLI-02170-101-t1c.nii.gz,../../DataSet/BraTS2024-BraTS-GLI-TrainingData/BraTS-GLI-02170-101/BraTS-GLI-02170-101-t2w.nii.gz,../../DataSet/BraTS2024-BraTS-GLI-TrainingData/BraTS-GLI-02170-101/BraTS-GLI-02170-101-t2f.nii.gz,../../DataSet/BraTS2024-BraTS-GLI-TrainingData/BraTS-GLI-02170-101/BraTS-GLI-02170-101-t1n.nii.gz,../../DataSet/BraTS2024-BraTS-GLI-TrainingData/BraTS-GLI-02170-101/BraTS-GLI-02170-101-seg.nii.gz,55,87,105,31,80,54,122,66,148,49,68,82
02755-100,../../DataSet/BraTS2024-BraTS-GLI-TrainingData/BraTS-GLI-02755-100/BraTS-GLI-02755-100-t1c.nii.gz,../../DataSet/BraTS2024-BraTS-GLI-TrainingData/BraTS-GLI-02755-100/BraTS-GLI-02755-100-t2w.nii.gz,../../DataSet/BraTS2024-BraTS-GLI-TrainingData/BraTS-GLI-02755-100/BraTS-GLI-02755-100-t2f.nii.gz,../../DataSet/BraTS2024-BraTS-GLI-TrainingData/BraTS-GLI-02755-100/BraTS-GLI-02755-100-t1n.nii.gz,../../DataSet/BraTS2024-BraTS-GLI-TrainingData/BraTS-GLI-02755-100/BraTS-GLI-02755-100-seg.nii.gz,68,129,130,46,86,85,176,104,154,40,91,50
02334-100,../../DataSet/BraTS2024-BraTS-GLI-TrainingData/BraTS-GLI-02334-100/BraTS-GLI-02334-100-t1c.nii.gz,../../DataSet/BraTS2024-BraTS-GLI-TrainingData/BraTS-GLI-02334-100/BraTS-GLI-02334-100-t2w.nii.gz,../../DataSet/BraTS2024-BraTS-GLI-TrainingData/BraTS-GLI-02334-100/BraTS-GLI-02334-100-t2f.nii.gz,../../DataSet/BraTS2024-BraTS-GLI-TrainingData/BraTS-GLI-02334-100/BraTS-GLI-02334-100-t1n.nii.gz,../../DataSet/BraTS2024-BraTS-GLI-TrainingData/BraTS-GLI-02334-100/BraTS-GLI-02334-100-seg.nii.gz,120,124,67,98,142,89,160,53,93,44,71,40
02192-102,../../DataSet/BraTS2024-BraTS-GLI-TrainingData/BraTS-GLI-02192-102/BraTS-GLI-02192-102-t1c.nii.gz,../../DataSet/BraTS2024-BraTS-GLI-TrainingData/BraTS-GLI-02192-102/BraTS-GLI-02192-102-t2w.nii.gz,../../DataSet/BraTS2024-BraTS-GLI-TrainingData/BraTS-GLI-02192-102/BraTS-GLI-02192-102-t2f.nii.gz,../../DataSet/BraTS2024-BraTS-GLI-TrainingData/BraTS-GLI-02192-102/BraTS-GLI-02192-102-t1n.nii.gz,../../DataSet/BraTS2024-BraTS-GLI-TrainingData/BraTS-GLI-02192-102/BraTS-GLI-02192-102-seg.nii.gz,112,60,90,54,144,21,100,54,128,90,79,74
02968-100,../../DataSet/BraTS2024-BraTS-GLI-TrainingData/BraTS-GLI-02968-100/BraTS-GLI-02968-100-t1c.nii.gz,../../DataSet/BraTS2024-BraTS-GLI-TrainingData/BraTS-GLI-02968-100/BraTS-GLI-02968-100-t2w.nii.gz,../../DataSet/BraTS2024-BraTS-GLI-TrainingData/BraTS-GLI-02968-100/BraTS-GLI-02968-100-t2f.nii.gz,../../DataSet/BraTS2024-BraTS-GLI-TrainingData/BraTS-GLI-02968-100/BraTS-GLI-02968-100-t1n.nii.gz,../../DataSet/BraTS2024-BraTS-GLI-TrainingData/BraTS-GLI-02968-100/BraTS-GLI-02968-100-seg.nii.gz,62,155,91,45,113,97,178,74,114,68,81,40
02285-102,../../DataSet/BraTS2024-BraTS-GLI-TrainingData/BraTS-GLI-02285-102/BraTS-GLI-02285-102-t1c.nii.gz,../../DataSet/BraTS2024-BraTS-GLI-TrainingData/BraTS-GLI-02285-102/BraTS-GLI-02285-102-t2w.nii.gz,../../DataSet/BraTS2024-BraTS-GLI-TrainingData/BraTS-GLI-02285-102/BraTS-GLI-02285-102-t2f.nii.gz,../../DataSet/BraTS2024-BraTS-GLI-TrainingData/BraTS-GLI-02285-102/BraTS-GLI-02285-102-t1n.nii.gz,../../DataSet/BraTS2024-BraTS-GLI-TrainingData/BraTS-GLI-02285-102/BraTS-GLI-02285-102-seg.nii.gz,108,58,95,89,130,35,86,61,127,41,51,66
02498-101,../../DataSet/BraTS2024-BraTS-GLI-TrainingData/BraTS-GLI-02498-101/BraTS-GLI-02498-101-t1c.nii.gz,../../DataSet/BraTS2024-BraTS-GLI-TrainingData/BraTS-GLI-02498-101/BraTS-GLI-02498-101-t2w.nii.gz,../../DataSet/BraTS2024-BraTS-GLI-TrainingData/BraTS-GLI-02498-101/BraTS-GLI-02498-101-t2f.nii.gz,../../DataSet/BraTS2024-BraTS-GLI-TrainingData/BraTS-GLI-02498-101/BraTS-GLI-02498-101-t1n.nii.gz,../../DataSet/BraTS2024-BraTS-GLI-TrainingData/BraTS-GLI-02498-101/BraTS-GLI-02498-101-seg.nii.gz,107,117,123,92,127,92,146,94,151,35,54,57
02348-100,../../DataSet/BraTS2024-BraTS-GLI-TrainingData/BraTS-GLI-02348-100/BraTS-GLI-02348-100-t1c.nii.gz,../../DataSet/BraTS2024-BraTS-GLI-TrainingData/BraTS-GLI-02348-100/BraTS-GLI-02348-100-t2w.nii.gz,../../DataSet/BraTS2024-BraTS-GLI-TrainingData/BraTS-GLI-02348-100/BraTS-GLI-02348-100-t2f.nii.gz,../../DataSet/BraTS2024-BraTS-GLI-TrainingData/BraTS-GLI-02348-100/BraTS-GLI-02348-100-t1n.nii.gz,../../DataSet/BraTS2024-BraTS-GLI-TrainingData/BraTS-GLI-02348-100/BraTS-GLI-02348-100-seg.nii.gz,99,134,122,47,133,105,174,90,156,86,69,66
03031-100,../../DataSet/BraTS2024-BraTS-GLI-TrainingData/BraTS-GLI-03031-100/BraTS-GLI-03031-100-t1c.nii.gz,../../DataSet/BraTS2024-BraTS-GLI-TrainingData/BraTS-GLI-03031-100/BraTS-GLI-03031-100-t2w.nii.gz,../../DataSet/BraTS2024-BraTS-GLI-TrainingData/BraTS-GLI-03031-100/BraTS-GLI-03031-100-t2f.nii.gz,../../DataSet/BraTS2024-BraTS-GLI-TrainingData/BraTS-GLI-03031-100/BraTS-GLI-03031-100-t1n.nii.gz,../../DataSet/BraTS2024-BraTS-GLI-TrainingData/BraTS-GLI-03031-100/BraTS-GLI-03031-100-seg.nii.gz,50,129,77,26,72,96,158,44,103,46,62,59
02847-101,../../DataSet/BraTS2024-BraTS-GLI-TrainingData/BraTS-GLI-02847-101/BraTS-GLI-02847-101-t1c.nii.gz,../../DataSet/BraTS2024-BraTS-GLI-TrainingData/BraTS-GLI-02847-101/BraTS-GLI-02847-101-t2w.nii.gz,../../DataSet/BraTS2024-BraTS-GLI-TrainingData/BraTS-GLI-02847-101/BraTS-GLI-02847-101-t2f.nii.gz,../../DataSet/BraTS2024-BraTS-GLI-TrainingData/BraTS-GLI-02847-101/BraTS-GLI-02847-101-t1n.nii.gz,../../DataSet/BraTS2024-BraTS-GLI-TrainingData/BraTS-GLI-02847-101/BraTS-GLI-02847-101-seg.nii.gz,110,116,127,68,135,64,157,91,156,67,93,65
02914-100,../../DataSet/BraTS2024-BraTS-GLI-TrainingData/BraTS-GLI-02914-100/BraTS-GLI-02914-100-t1c.nii.gz,../../DataSet/BraTS2024-BraTS-GLI-TrainingData/BraTS-GLI-02914-100/BraTS-GLI-02914-100-t2w.nii.gz,../../DataSet/BraTS2024-BraTS-GLI-TrainingData/BraTS-GLI-02914-100/BraTS-GLI-02914-100-t2f.nii.gz,../../DataSet/BraTS2024-BraTS-GLI-TrainingData/BraTS-GLI-02914-100/BraTS-GLI-02914-100-t1n.nii.gz,../../DataSet/BraTS2024-BraTS-GLI-TrainingData/BraTS-GLI-02914-100/BraTS-GLI-02914-100-seg.nii.gz,100,94,96,60,146,48,143,65,137,86,95,72
02111-107,../../DataSet/BraTS2024-BraTS-GLI-TrainingData/BraTS-GLI-02111-107/BraTS-GLI-02111-107-t1c.nii.gz,../../DataSet/BraTS2024-BraTS-GLI-TrainingData/BraTS-GLI-02111-107/BraTS-GLI-02111-107-t2w.nii.gz,../../DataSet/BraTS2024-BraTS-GLI-TrainingData/BraTS-GLI-02111-107/BraTS-GLI-02111-107-t2f.nii.gz,../../DataSet/BraTS2024-BraTS-GLI-TrainingData/BraTS-GLI-02111-107/BraTS-GLI-02111-107-t1n.nii.gz,../../DataSet/BraTS2024-BraTS-GLI-TrainingData/BraTS-GLI-02111-107/BraTS-GLI-02111-107-seg.nii.gz,72,91,117,55,115,50,144,65,160,60,94,95
00549-101,../../DataSet/BraTS2024-BraTS-GLI-TrainingData/BraTS-GLI-00549-101/BraTS-GLI-00549-101-t1c.nii.gz,../../DataSet/BraTS2024-BraTS-GLI-TrainingData/BraTS-GLI-00549-101/BraTS-GLI-00549-101-t2w.nii.gz,../../DataSet/BraTS2024-BraTS-GLI-TrainingData/BraTS-GLI-00549-101/BraTS-GLI-00549-101-t2f.nii.gz,../../DataSet/BraTS2024-BraTS-GLI-TrainingData/BraTS-GLI-00549-101/BraTS-GLI-00549-101-t1n.nii.gz,../../DataSet/BraTS2024-BraTS-GLI-TrainingData/BraTS-GLI-00549-101/BraTS-GLI-00549-101-seg.nii.gz,69,150,103,46,85,126,173,88,127,39,47,39
02093-106,../../DataSet/BraTS2024-BraTS-GLI-TrainingData/BraTS-GLI-02093-106/BraTS-GLI-02093-106-t1c.nii.gz,../../DataSet/BraTS2024-BraTS-GLI-TrainingData/BraTS-GLI-02093-106/BraTS-GLI-02093-106-t2w.nii.gz,../../DataSet/BraTS2024-BraTS-GLI-TrainingData/BraTS-GLI-02093-106/BraTS-GLI-02093-106-t2f.nii.gz,../../DataSet/BraTS2024-BraTS-GLI-TrainingData/BraTS-GLI-02093-106/BraTS-GLI-02093-106-t1n.nii.gz,../../DataSet/BraTS2024-BraTS-GLI-TrainingData/BraTS-GLI-02093-106/BraTS-GLI-02093-106-seg.nii.gz,108,172,92,68,138,116,203,52,139,70,87,87
02918-101,../../DataSet/BraTS2024-BraTS-GLI-TrainingData/BraTS-GLI-02918-101/BraTS-GLI-02918-101-t1c.nii.gz,../../DataSet/BraTS2024-BraTS-GLI-TrainingData/BraTS-GLI-02918-101/BraTS-GLI-02918-101-t2w.nii.gz,../../DataSet/BraTS2024-BraTS-GLI-TrainingData/BraTS-GLI-02918-101/BraTS-GLI-02918-101-t2f.nii.gz,../../DataSet/BraTS2024-BraTS-GLI-TrainingData/BraTS-GLI-02918-101/BraTS-GLI-02918-101-t1n.nii.gz,../../DataSet/BraTS2024-BraTS-GLI-TrainingData/BraTS-GLI-02918-101/BraTS-GLI-02918-101-seg.nii.gz,107,130,127,73,130,88,167,95,158,57,79,63
02217-100,../../DataSet/BraTS2024-BraTS-GLI-TrainingData/BraTS-GLI-02217-100/BraTS-GLI-02217-100-t1c.nii.gz,../../DataSet/BraTS2024-BraTS-GLI-TrainingData/BraTS-GLI-02217-100/BraTS-GLI-02217-100-t2w.nii.gz,../../DataSet/BraTS2024-BraTS-GLI-TrainingData/BraTS-GLI-02217-100/BraTS-GLI-02217-100-t2f.nii.gz,../../DataSet/BraTS2024-BraTS-GLI-TrainingData/BraTS-GLI-02217-100/BraTS-GLI-02217-100-t1n.nii.gz,../../DataSet/BraTS2024-BraTS-GLI-TrainingData/BraTS-GLI-02217-100/BraTS-GLI-02217-100-seg.nii.gz,126,125,93,112,144,79,145,49,115,32,66,66
02561-100,../../DataSet/BraTS2024-BraTS-GLI-TrainingData/BraTS-GLI-02561-100/BraTS-GLI-02561-100-t1c.nii.gz,../../DataSet/BraTS2024-BraTS-GLI-TrainingData/BraTS-GLI-02561-100/BraTS-GLI-02561-100-t2w.nii.gz,../../DataSet/BraTS2024-BraTS-GLI-TrainingData/BraTS-GLI-02561-100/BraTS-GLI-02561-100-t2f.nii.gz,../../DataSet/BraTS2024-BraTS-GLI-TrainingData/BraTS-GLI-02561-100/BraTS-GLI-02561-100-t1n.nii.gz,../../DataSet/BraTS2024-BraTS-GLI-TrainingData/BraTS-GLI-02561-100/BraTS-GLI-02561-100-seg.nii.gz,73,133,96,46,123,92,171,69,128,77,79,59
02891-101,../../DataSet/BraTS2024-BraTS-GLI-TrainingData/BraTS-GLI-02891-101/BraTS-GLI-02891-101-t1c.nii.gz,../../DataSet/BraTS2024-BraTS-GLI-TrainingData/BraTS-GLI-02891-101/BraTS-GLI-02891-101-t2w.nii.gz,../../DataSet/BraTS2024-BraTS-GLI-TrainingData/BraTS-GLI-02891-101/BraTS-GLI-02891-101-t2f.nii.gz,../../DataSet/BraTS2024-BraTS-GLI-TrainingData/BraTS-GLI-02891-101/BraTS-GLI-02891-101-t1n.nii.gz,../../DataSet/BraTS2024-BraTS-GLI-TrainingData/BraTS-GLI-02891-101/BraTS-GLI-02891-101-seg.nii.gz,64,59,98,41,85,32,96,72,129,44,64,57
02100-100,../../DataSet/BraTS2024-BraTS-GLI-TrainingData/BraTS-GLI-02100-100/BraTS-GLI-02100-100-t1c.nii.gz,../../DataSet/BraTS2024-BraTS-GLI-TrainingData/BraTS-GLI-02100-100/BraTS-GLI-02100-100-t2w.nii.gz,../../DataSet/BraTS2024-BraTS-GLI-TrainingData/BraTS-GLI-02100-100/BraTS-GLI-02100-100-t2f.nii.gz,../../DataSet/BraTS2024-BraTS-GLI-TrainingData/BraTS-GLI-02100-100/BraTS-GLI-02100-100-t1n.nii.gz,../../DataSet/BraTS2024-BraTS-GLI-TrainingData/BraTS-GLI-02100-100/BraTS-GLI-02100-100-seg.nii.gz,124,74,119,109,147,55,98,103,140,38,43,37
02837-100,../../DataSet/BraTS2024-BraTS-GLI-TrainingData/BraTS-GLI-02837-100/BraTS-GLI-02837-100-t1c.nii.gz,../../DataSet/BraTS2024-BraTS-GLI-TrainingData/BraTS-GLI-02837-100/BraTS-GLI-02837-100-t2w.nii.gz,../../DataSet/BraTS2024-BraTS-GLI-TrainingData/BraTS-GLI-02837-100/BraTS-GLI-02837-100-t2f.nii.gz,../../DataSet/BraTS2024-BraTS-GLI-TrainingData/BraTS-GLI-02837-100/BraTS-GLI-02837-100-t1n.nii.gz,../../DataSet/BraTS2024-BraTS-GLI-TrainingData/BraTS-GLI-02837-100/BraTS-GLI-02837-100-seg.nii.gz,71,75,90,53,88,49,98,58,117,35,49,59
02752-100,../../DataSet/BraTS2024-BraTS-GLI-TrainingData/BraTS-GLI-02752-100/BraTS-GLI-02752-100-t1c.nii.gz,../../DataSet/BraTS2024-BraTS-GLI-TrainingData/BraTS-GLI-02752-100/BraTS-GLI-02752-100-t2w.nii.gz,../../DataSet/BraTS2024-BraTS-GLI-TrainingData/BraTS-GLI-02752-100/BraTS-GLI-02752-100-t2f.nii.gz,../../DataSet/BraTS2024-BraTS-GLI-TrainingData/BraTS-GLI-02752-100/BraTS-GLI-02752-100-t1n.nii.gz,../../DataSet/BraTS2024-BraTS-GLI-TrainingData/BraTS-GLI-02752-100/BraTS-GLI-02752-100-seg.nii.gz,68,164,93,45,89,134,193,68,128,44,59,60
02788-101,../../DataSet/BraTS2024-BraTS-GLI-TrainingData/BraTS-GLI-02788-101/BraTS-GLI-02788-101-t1c.nii.gz,../../DataSet/BraTS2024-BraTS-GLI-TrainingData/BraTS-GLI-02788-101/BraTS-GLI-02788-101-t2w.nii.gz,../../DataSet/BraTS2024-BraTS-GLI-TrainingData/BraTS-GLI-02788-101/BraTS-GLI-02788-101-t2f.nii.gz,../../DataSet/BraTS2024-BraTS-GLI-TrainingData/BraTS-GLI-02788-101/BraTS-GLI-02788-101-t1n.nii.gz,../../DataSet/BraTS2024-BraTS-GLI-TrainingData/BraTS-GLI-02788-101/BraTS-GLI-02788-101-seg.nii.gz,45,81,105,24,73,65,103,87,124,49,38,37
02632-102,../../DataSet/BraTS2024-BraTS-GLI-TrainingData/BraTS-GLI-02632-102/BraTS-GLI-02632-102-t1c.nii.gz,../../DataSet/BraTS2024-BraTS-GLI-TrainingData/BraTS-GLI-02632-102/BraTS-GLI-02632-102-t2w.nii.gz,../../DataSet/BraTS2024-BraTS-GLI-TrainingData/BraTS-GLI-02632-102/BraTS-GLI-02632-102-t2f.nii.gz,../../DataSet/BraTS2024-BraTS-GLI-TrainingData/BraTS-GLI-02632-102/BraTS-GLI-02632-102-t1n.nii.gz,../../DataSet/BraTS2024-BraTS-GLI-TrainingData/BraTS-GLI-02632-102/BraTS-GLI-02632-102-seg.nii.gz,122,59,87,99,148,30,99,58,116,49,69,58
02865-101,../../DataSet/BraTS2024-BraTS-GLI-TrainingData/BraTS-GLI-02865-101/BraTS-GLI-02865-101-t1c.nii.gz,../../DataSet/BraTS2024-BraTS-GLI-TrainingData/BraTS-GLI-02865-101/BraTS-GLI-02865-101-t2w.nii.gz,../../DataSet/BraTS2024-BraTS-GLI-TrainingData/BraTS-GLI-02865-101/BraTS-GLI-02865-101-t2f.nii.gz,../../DataSet/BraTS2024-BraTS-GLI-TrainingData/BraTS-GLI-02865-101/BraTS-GLI-02865-101-t1n.nii.gz,../../DataSet/BraTS2024-BraTS-GLI-TrainingData/BraTS-GLI-02865-101/BraTS-GLI-02865-101-seg.nii.gz,68,94,117,47,94,61,132,91,150,47,71,59
02653-100,../../DataSet/BraTS2024-BraTS-GLI-TrainingData/BraTS-GLI-02653-100/BraTS-GLI-02653-100-t1c.nii.gz,../../DataSet/BraTS2024-BraTS-GLI-TrainingData/BraTS-GLI-02653-100/BraTS-GLI-02653-100-t2w.nii.gz,../../DataSet/BraTS2024-BraTS-GLI-TrainingData/BraTS-GLI-02653-100/BraTS-GLI-02653-100-t2f.nii.gz,../../DataSet/BraTS2024-BraTS-GLI-TrainingData/BraTS-GLI-02653-100/BraTS-GLI-02653-100-t1n.nii.gz,../../DataSet/BraTS2024-BraTS-GLI-TrainingData/BraTS-GLI-02653-100/BraTS-GLI-02653-100-seg.nii.gz,138,100,104,115,158,75,122,83,130,43,47,47
03018-101,../../DataSet/BraTS2024-BraTS-GLI-TrainingData/BraTS-GLI-03018-101/BraTS-GLI-03018-101-t1c.nii.gz,../../DataSet/BraTS2024-BraTS-GLI-TrainingData/BraTS-GLI-03018-101/BraTS-GLI-03018-101-t2w.nii.gz,../../DataSet/BraTS2024-BraTS-GLI-TrainingData/BraTS-GLI-03018-101/BraTS-GLI-03018-101-t2f.nii.gz,../../DataSet/BraTS2024-BraTS-GLI-TrainingData/BraTS-GLI-03018-101/BraTS-GLI-03018-101-t1n.nii.gz,../../DataSet/BraTS2024-BraTS-GLI-TrainingData/BraTS-GLI-03018-101/BraTS-GLI-03018-101-seg.nii.gz,127,76,101,105,150,56,114,70,123,45,58,53
02239-101,../../DataSet/BraTS2024-BraTS-GLI-TrainingData/BraTS-GLI-02239-101/BraTS-GLI-02239-101-t1c.nii.gz,../../DataSet/BraTS2024-BraTS-GLI-TrainingData/BraTS-GLI-02239-101/BraTS-GLI-02239-101-t2w.nii.gz,../../DataSet/BraTS2024-BraTS-GLI-TrainingData/BraTS-GLI-02239-101/BraTS-GLI-02239-101-t2f.nii.gz,../../DataSet/BraTS2024-BraTS-GLI-TrainingData/BraTS-GLI-02239-101/BraTS-GLI-02239-101-t1n.nii.gz,../../DataSet/BraTS2024-BraTS-GLI-TrainingData/BraTS-GLI-02239-101/BraTS-GLI-02239-101-seg.nii.gz,53,129,52,33,73,108,151,38,74,40,43,36
02188-100,../../DataSet/BraTS2024-BraTS-GLI-TrainingData/BraTS-GLI-02188-100/BraTS-GLI-02188-100-t1c.nii.gz,../../DataSet/BraTS2024-BraTS-GLI-TrainingData/BraTS-GLI-02188-100/BraTS-GLI-02188-100-t2w.nii.gz,../../DataSet/BraTS2024-BraTS-GLI-TrainingData/BraTS-GLI-02188-100/BraTS-GLI-02188-100-t2f.nii.gz,../../DataSet/BraTS2024-BraTS-GLI-TrainingData/BraTS-GLI-02188-100/BraTS-GLI-02188-100-t1n.nii.gz,../../DataSet/BraTS2024-BraTS-GLI-TrainingData/BraTS-GLI-02188-100/BraTS-GLI-02188-100-seg.nii.gz,64,113,130,45,83,94,131,106,155,38,37,49
02245-101,../../DataSet/BraTS2024-BraTS-GLI-TrainingData/BraTS-GLI-02245-101/BraTS-GLI-02245-101-t1c.nii.gz,../../DataSet/BraTS2024-BraTS-GLI-TrainingData/BraTS-GLI-02245-101/BraTS-GLI-02245-101-t2w.nii.gz,../../DataSet/BraTS2024-BraTS-GLI-TrainingData/BraTS-GLI-02245-101/BraTS-GLI-02245-101-t2f.nii.gz,../../DataSet/BraTS2024-BraTS-GLI-TrainingData/BraTS-GLI-02245-101/BraTS-GLI-02245-101-t1n.nii.gz,../../DataSet/BraTS2024-BraTS-GLI-TrainingData/BraTS-GLI-02245-101/BraTS-GLI-02245-101-seg.nii.gz,78,131,120,59,90,104,164,92,145,31,60,53
02941-101,../../DataSet/BraTS2024-BraTS-GLI-TrainingData/BraTS-GLI-02941-101/BraTS-GLI-02941-101-t1c.nii.gz,../../DataSet/BraTS2024-BraTS-GLI-TrainingData/BraTS-GLI-02941-101/BraTS-GLI-02941-101-t2w.nii.gz,../../DataSet/BraTS2024-BraTS-GLI-TrainingData/BraTS-GLI-02941-101/BraTS-GLI-02941-101-t2f.nii.gz,../../DataSet/BraTS2024-BraTS-GLI-TrainingData/BraTS-GLI-02941-101/BraTS-GLI-02941-101-t1n.nii.gz,../../DataSet/BraTS2024-BraTS-GLI-TrainingData/BraTS-GLI-02941-101/BraTS-GLI-02941-101-seg.nii.gz,106,87,132,90,131,53,127,108,157,41,74,49
02152-101,../../DataSet/BraTS2024-BraTS-GLI-TrainingData/BraTS-GLI-02152-101/BraTS-GLI-02152-101-t1c.nii.gz,../../DataSet/BraTS2024-BraTS-GLI-TrainingData/BraTS-GLI-02152-101/BraTS-GLI-02152-101-t2w.nii.gz,../../DataSet/BraTS2024-BraTS-GLI-TrainingData/BraTS-GLI-02152-101/BraTS-GLI-02152-101-t2f.nii.gz,../../DataSet/BraTS2024-BraTS-GLI-TrainingData/BraTS-GLI-02152-101/BraTS-GLI-02152-101-t1n.nii.gz,../../DataSet/BraTS2024-BraTS-GLI-TrainingData/BraTS-GLI-02152-101/BraTS-GLI-02152-101-seg.nii.gz,60,71,90,31,86,32,114,54,130,55,82,76
02093-108,../../DataSet/BraTS2024-BraTS-GLI-TrainingData/BraTS-GLI-02093-108/BraTS-GLI-02093-108-t1c.nii.gz,../../DataSet/BraTS2024-BraTS-GLI-TrainingData/BraTS-GLI-02093-108/BraTS-GLI-02093-108-t2w.nii.gz,../../DataSet/BraTS2024-BraTS-GLI-TrainingData/BraTS-GLI-02093-108/BraTS-GLI-02093-108-t2f.nii.gz,../../DataSet/BraTS2024-BraTS-GLI-TrainingData/BraTS-GLI-02093-108/BraTS-GLI-02093-108-t1n.nii.gz,../../DataSet/BraTS2024-BraTS-GLI-TrainingData/BraTS-GLI-02093-108/BraTS-GLI-02093-108-seg.nii.gz,109,171,97,68,139,123,200,56,144,71,77,88
02623-101,../../DataSet/BraTS2024-BraTS-GLI-TrainingData/BraTS-GLI-02623-101/BraTS-GLI-02623-101-t1c.nii.gz,../../DataSet/BraTS2024-BraTS-GLI-TrainingData/BraTS-GLI-02623-101/BraTS-GLI-02623-101-t2w.nii.gz,../../DataSet/BraTS2024-BraTS-GLI-TrainingData/BraTS-GLI-02623-101/BraTS-GLI-02623-101-t2f.nii.gz,../../DataSet/BraTS2024-BraTS-GLI-TrainingData/BraTS-GLI-02623-101/BraTS-GLI-02623-101-t1n.nii.gz,../../DataSet/BraTS2024-BraTS-GLI-TrainingData/BraTS-GLI-02623-101/BraTS-GLI-02623-101-seg.nii.gz,87,82,106,82,91,68,99,98,112,9,31,14
02242-101,../../DataSet/BraTS2024-BraTS-GLI-TrainingData/BraTS-GLI-02242-101/BraTS-GLI-02242-101-t1c.nii.gz,../../DataSet/BraTS2024-BraTS-GLI-TrainingData/BraTS-GLI-02242-101/BraTS-GLI-02242-101-t2w.nii.gz,../../DataSet/BraTS2024-BraTS-GLI-TrainingData/BraTS-GLI-02242-101/BraTS-GLI-02242-101-t2f.nii.gz,../../DataSet/BraTS2024-BraTS-GLI-TrainingData/BraTS-GLI-02242-101/BraTS-GLI-02242-101-t1n.nii.gz,../../DataSet/BraTS2024-BraTS-GLI-TrainingData/BraTS-GLI-02242-101/BraTS-GLI-02242-101-seg.nii.gz,114,96,73,89,145,51,147,45,109,56,96,64
02946-101,../../DataSet/BraTS2024-BraTS-GLI-TrainingData/BraTS-GLI-02946-101/BraTS-GLI-02946-101-t1c.nii.gz,../../DataSet/BraTS2024-BraTS-GLI-TrainingData/BraTS-GLI-02946-101/BraTS-GLI-02946-101-t2w.nii.gz,../../DataSet/BraTS2024-BraTS-GLI-TrainingData/BraTS-GLI-02946-101/BraTS-GLI-02946-101-t2f.nii.gz,../../DataSet/BraTS2024-BraTS-GLI-TrainingData/BraTS-GLI-02946-101/BraTS-GLI-02946-101-t1n.nii.gz,../../DataSet/BraTS2024-BraTS-GLI-TrainingData/BraTS-GLI-02946-101/BraTS-GLI-02946-101-seg.nii.gz,74,95,128,60,90,72,114,117,153,30,42,36
02155-101,../../DataSet/BraTS2024-BraTS-GLI-TrainingData/BraTS-GLI-02155-101/BraTS-GLI-02155-101-t1c.nii.gz,../../DataSet/BraTS2024-BraTS-GLI-TrainingData/BraTS-GLI-02155-101/BraTS-GLI-02155-101-t2w.nii.gz,../../DataSet/BraTS2024-BraTS-GLI-TrainingData/BraTS-GLI-02155-101/BraTS-GLI-02155-101-t2f.nii.gz,../../DataSet/BraTS2024-BraTS-GLI-TrainingData/BraTS-GLI-02155-101/BraTS-GLI-02155-101-t1n.nii.gz,../../DataSet/BraTS2024-BraTS-GLI-TrainingData/BraTS-GLI-02155-101/BraTS-GLI-02155-101-seg.nii.gz,79,130,115,51,113,90,165,77,153,62,75,76
02770-100,../../DataSet/BraTS2024-BraTS-GLI-TrainingData/BraTS-GLI-02770-100/BraTS-GLI-02770-100-t1c.nii.gz,../../DataSet/BraTS2024-BraTS-GLI-TrainingData/BraTS-GLI-02770-100/BraTS-GLI-02770-100-t2w.nii.gz,../../DataSet/BraTS2024-BraTS-GLI-TrainingData/BraTS-GLI-02770-100/BraTS-GLI-02770-100-t2f.nii.gz,../../DataSet/BraTS2024-BraTS-GLI-TrainingData/BraTS-GLI-02770-100/BraTS-GLI-02770-100-t1n.nii.gz,../../DataSet/BraTS2024-BraTS-GLI-TrainingData/BraTS-GLI-02770-100/BraTS-GLI-02770-100-seg.nii.gz,93,90,120,43,139,50,133,92,153,96,83,61
02862-101,../../DataSet/BraTS2024-BraTS-GLI-TrainingData/BraTS-GLI-02862-101/BraTS-GLI-02862-101-t1c.nii.gz,../../DataSet/BraTS2024-BraTS-GLI-TrainingData/BraTS-GLI-02862-101/BraTS-GLI-02862-101-t2w.nii.gz,../../DataSet/BraTS2024-BraTS-GLI-TrainingData/BraTS-GLI-02862-101/BraTS-GLI-02862-101-t2f.nii.gz,../../DataSet/BraTS2024-BraTS-GLI-TrainingData/BraTS-GLI-02862-101/BraTS-GLI-02862-101-t1n.nii.gz,../../DataSet/BraTS2024-BraTS-GLI-TrainingData/BraTS-GLI-02862-101/BraTS-GLI-02862-101-seg.nii.gz,129,132,60,112,146,110,148,50,74,34,38,24
02654-100,../../DataSet/BraTS2024-BraTS-GLI-TrainingData/BraTS-GLI-02654-100/BraTS-GLI-02654-100-t1c.nii.gz,../../DataSet/BraTS2024-BraTS-GLI-TrainingData/BraTS-GLI-02654-100/BraTS-GLI-02654-100-t2w.nii.gz,../../DataSet/BraTS2024-BraTS-GLI-TrainingData/BraTS-GLI-02654-100/BraTS-GLI-02654-100-t2f.nii.gz,../../DataSet/BraTS2024-BraTS-GLI-TrainingData/BraTS-GLI-02654-100/BraTS-GLI-02654-100-t1n.nii.gz,../../DataSet/BraTS2024-BraTS-GLI-TrainingData/BraTS-GLI-02654-100/BraTS-GLI-02654-100-seg.nii.gz,110,161,83,52,147,102,198,47,137,95,96,90
02217-104,../../DataSet/BraTS2024-BraTS-GLI-TrainingData/BraTS-GLI-02217-104/BraTS-GLI-02217-104-t1c.nii.gz,../../DataSet/BraTS2024-BraTS-GLI-TrainingData/BraTS-GLI-02217-104/BraTS-GLI-02217-104-t2w.nii.gz,../../DataSet/BraTS2024-BraTS-GLI-TrainingData/BraTS-GLI-02217-104/BraTS-GLI-02217-104-t2f.nii.gz,../../DataSet/BraTS2024-BraTS-GLI-TrainingData/BraTS-GLI-02217-104/BraTS-GLI-02217-104-t1n.nii.gz,../../DataSet/BraTS2024-BraTS-GLI-TrainingData/BraTS-GLI-02217-104/BraTS-GLI-02217-104-seg.nii.gz,130,124,95,111,152,101,148,70,116,41,47,46
02931-100,../../DataSet/BraTS2024-BraTS-GLI-TrainingData/BraTS-GLI-02931-100/BraTS-GLI-02931-100-t1c.nii.gz,../../DataSet/BraTS2024-BraTS-GLI-TrainingData/BraTS-GLI-02931-100/BraTS-GLI-02931-100-t2w.nii.gz,../../DataSet/BraTS2024-BraTS-GLI-TrainingData/BraTS-GLI-02931-100/BraTS-GLI-02931-100-t2f.nii.gz,../../DataSet/BraTS2024-BraTS-GLI-TrainingData/BraTS-GLI-02931-100/BraTS-GLI-02931-100-t1n.nii.gz,../../DataSet/BraTS2024-BraTS-GLI-TrainingData/BraTS-GLI-02931-100/BraTS-GLI-02931-100-seg.nii.gz,120,150,105,103,143,126,176,74,127,40,50,53
02548-101,../../DataSet/BraTS2024-BraTS-GLI-TrainingData/BraTS-GLI-02548-101/BraTS-GLI-02548-101-t1c.nii.gz,../../DataSet/BraTS2024-BraTS-GLI-TrainingData/BraTS-GLI-02548-101/BraTS-GLI-02548-101-t2w.nii.gz,../../DataSet/BraTS2024-BraTS-GLI-TrainingData/BraTS-GLI-02548-101/BraTS-GLI-02548-101-t2f.nii.gz,../../DataSet/BraTS2024-BraTS-GLI-TrainingData/BraTS-GLI-02548-101/BraTS-GLI-02548-101-t1n.nii.gz,../../DataSet/BraTS2024-BraTS-GLI-TrainingData/BraTS-GLI-02548-101/BraTS-GLI-02548-101-seg.nii.gz,126,80,68,102,150,37,123,45,94,48,86,49
02111-103,../../DataSet/BraTS2024-BraTS-GLI-TrainingData/BraTS-GLI-02111-103/BraTS-GLI-02111-103-t1c.nii.gz,../../DataSet/BraTS2024-BraTS-GLI-TrainingData/BraTS-GLI-02111-103/BraTS-GLI-02111-103-t2w.nii.gz,../../DataSet/BraTS2024-BraTS-GLI-TrainingData/BraTS-GLI-02111-103/BraTS-GLI-02111-103-t2f.nii.gz,../../DataSet/BraTS2024-BraTS-GLI-TrainingData/BraTS-GLI-02111-103/BraTS-GLI-02111-103-t1n.nii.gz,../../DataSet/BraTS2024-BraTS-GLI-TrainingData/BraTS-GLI-02111-103/BraTS-GLI-02111-103-seg.nii.gz,74,76,115,52,119,50,115,80,152,67,65,72
02093-102,../../DataSet/BraTS2024-BraTS-GLI-TrainingData/BraTS-GLI-02093-102/BraTS-GLI-02093-102-t1c.nii.gz,../../DataSet/BraTS2024-BraTS-GLI-TrainingData/BraTS-GLI-02093-102/BraTS-GLI-02093-102-t2w.nii.gz,../../DataSet/BraTS2024-BraTS-GLI-TrainingData/BraTS-GLI-02093-102/BraTS-GLI-02093-102-t2f.nii.gz,../../DataSet/BraTS2024-BraTS-GLI-TrainingData/BraTS-GLI-02093-102/BraTS-GLI-02093-102-t1n.nii.gz,../../DataSet/BraTS2024-BraTS-GLI-TrainingData/BraTS-GLI-02093-102/BraTS-GLI-02093-102-seg.nii.gz,109,172,91,70,138,121,202,52,139,68,81,87
02247-100,../../DataSet/BraTS2024-BraTS-GLI-TrainingData/BraTS-GLI-02247-100/BraTS-GLI-02247-100-t1c.nii.gz,../../DataSet/BraTS2024-BraTS-GLI-TrainingData/BraTS-GLI-02247-100/BraTS-GLI-02247-100-t2w.nii.gz,../../DataSet/BraTS2024-BraTS-GLI-TrainingData/BraTS-GLI-02247-100/BraTS-GLI-02247-100-t2f.nii.gz,../../DataSet/BraTS2024-BraTS-GLI-TrainingData/BraTS-GLI-02247-100/BraTS-GLI-02247-100-t1n.nii.gz,../../DataSet/BraTS2024-BraTS-GLI-TrainingData/BraTS-GLI-02247-100/BraTS-GLI-02247-100-seg.nii.gz,42,122,101,30,60,101,144,75,127,30,43,52
02992-100,../../DataSet/BraTS2024-BraTS-GLI-TrainingData/BraTS-GLI-02992-100/BraTS-GLI-02992-100-t1c.nii.gz,../../DataSet/BraTS2024-BraTS-GLI-TrainingData/BraTS-GLI-02992-100/BraTS-GLI-02992-100-t2w.nii.gz,../../DataSet/BraTS2024-BraTS-GLI-TrainingData/BraTS-GLI-02992-100/BraTS-GLI-02992-100-t2f.nii.gz,../../DataSet/BraTS2024-BraTS-GLI-TrainingData/BraTS-GLI-02992-100/BraTS-GLI-02992-100-t1n.nii.gz,../../DataSet/BraTS2024-BraTS-GLI-TrainingData/BraTS-GLI-02992-100/BraTS-GLI-02992-100-seg.nii.gz,75,101,129,59,93,79,133,104,157,34,54,53
02181-100,../../DataSet/BraTS2024-BraTS-GLI-TrainingData/BraTS-GLI-02181-100/BraTS-GLI-02181-100-t1c.nii.gz,../../DataSet/BraTS2024-BraTS-GLI-TrainingData/BraTS-GLI-02181-100/BraTS-GLI-02181-100-t2w.nii.gz,../../DataSet/BraTS2024-BraTS-GLI-TrainingData/BraTS-GLI-02181-100/BraTS-GLI-02181-100-t2f.nii.gz,../../DataSet/BraTS2024-BraTS-GLI-TrainingData/BraTS-GLI-02181-100/BraTS-GLI-02181-100-t1n.nii.gz,../../DataSet/BraTS2024-BraTS-GLI-TrainingData/BraTS-GLI-02181-100/BraTS-GLI-02181-100-seg.nii.gz,127,125,97,105,152,76,169,57,130,47,93,73
02775-101,../../DataSet/BraTS2024-BraTS-GLI-TrainingData/BraTS-GLI-02775-101/BraTS-GLI-02775-101-t1c.nii.gz,../../DataSet/BraTS2024-BraTS-GLI-TrainingData/BraTS-GLI-02775-101/BraTS-GLI-02775-101-t2w.nii.gz,../../DataSet/BraTS2024-BraTS-GLI-TrainingData/BraTS-GLI-02775-101/BraTS-GLI-02775-101-t2f.nii.gz,../../DataSet/BraTS2024-BraTS-GLI-TrainingData/BraTS-GLI-02775-101/BraTS-GLI-02775-101-t1n.nii.gz,../../DataSet/BraTS2024-BraTS-GLI-TrainingData/BraTS-GLI-02775-101/BraTS-GLI-02775-101-seg.nii.gz,128,112,72,103,152,72,143,51,97,49,71,46
02531-100,../../DataSet/BraTS2024-BraTS-GLI-TrainingData/BraTS-GLI-02531-100/BraTS-GLI-02531-100-t1c.nii.gz,../../DataSet/BraTS2024-BraTS-GLI-TrainingData/BraTS-GLI-02531-100/BraTS-GLI-02531-100-t2w.nii.gz,../../DataSet/BraTS2024-BraTS-GLI-TrainingData/BraTS-GLI-02531-100/BraTS-GLI-02531-100-t2f.nii.gz,../../DataSet/BraTS2024-BraTS-GLI-TrainingData/BraTS-GLI-02531-100/BraTS-GLI-02531-100-t1n.nii.gz,../../DataSet/BraTS2024-BraTS-GLI-TrainingData/BraTS-GLI-02531-100/BraTS-GLI-02531-100-seg.nii.gz,68,60,92,41,97,26,97,59,131,56,71,72
02999-101,../../DataSet/BraTS2024-BraTS-GLI-TrainingData/BraTS-GLI-02999-101/BraTS-GLI-02999-101-t1c.nii.gz,../../DataSet/BraTS2024-BraTS-GLI-TrainingData/BraTS-GLI-02999-101/BraTS-GLI-02999-101-t2w.nii.gz,../../DataSet/BraTS2024-BraTS-GLI-TrainingData/BraTS-GLI-02999-101/BraTS-GLI-02999-101-t2f.nii.gz,../../DataSet/BraTS2024-BraTS-GLI-TrainingData/BraTS-GLI-02999-101/BraTS-GLI-02999-101-t1n.nii.gz,../../DataSet/BraTS2024-BraTS-GLI-TrainingData/BraTS-GLI-02999-101/BraTS-GLI-02999-101-seg.nii.gz,114,77,112,94,137,42,116,78,144,43,74,66
02948-101,../../DataSet/BraTS2024-BraTS-GLI-TrainingData/BraTS-GLI-02948-101/BraTS-GLI-02948-101-t1c.nii.gz,../../DataSet/BraTS2024-BraTS-GLI-TrainingData/BraTS-GLI-02948-101/BraTS-GLI-02948-101-t2w.nii.gz,../../DataSet/BraTS2024-BraTS-GLI-TrainingData/BraTS-GLI-02948-101/BraTS-GLI-02948-101-t2f.nii.gz,../../DataSet/BraTS2024-BraTS-GLI-TrainingData/BraTS-GLI-02948-101/BraTS-GLI-02948-101-t1n.nii.gz,../../DataSet/BraTS2024-BraTS-GLI-TrainingData/BraTS-GLI-02948-101/BraTS-GLI-02948-101-seg.nii.gz,102,142,124,92,118,117,175,111,149,26,58,38
02230-101,../../DataSet/BraTS2024-BraTS-GLI-TrainingData/BraTS-GLI-02230-101/BraTS-GLI-02230-101-t1c.nii.gz,../../DataSet/BraTS2024-BraTS-GLI-TrainingData/BraTS-GLI-02230-101/BraTS-GLI-02230-101-t2w.nii.gz,../../DataSet/BraTS2024-BraTS-GLI-TrainingData/BraTS-GLI-02230-101/BraTS-GLI-02230-101-t2f.nii.gz,../../DataSet/BraTS2024-BraTS-GLI-TrainingData/BraTS-GLI-02230-101/BraTS-GLI-02230-101-t1n.nii.gz,../../DataSet/BraTS2024-BraTS-GLI-TrainingData/BraTS-GLI-02230-101/BraTS-GLI-02230-101-seg.nii.gz,110,135,115,60,148,114,160,84,149,88,46,65
02867-100,../../DataSet/BraTS2024-BraTS-GLI-TrainingData/BraTS-GLI-02867-100/BraTS-GLI-02867-100-t1c.nii.gz,../../DataSet/BraTS2024-BraTS-GLI-TrainingData/BraTS-GLI-02867-100/BraTS-GLI-02867-100-t2w.nii.gz,../../DataSet/BraTS2024-BraTS-GLI-TrainingData/BraTS-GLI-02867-100/BraTS-GLI-02867-100-t2f.nii.gz,../../DataSet/BraTS2024-BraTS-GLI-TrainingData/BraTS-GLI-02867-100/BraTS-GLI-02867-100-t1n.nii.gz,../../DataSet/BraTS2024-BraTS-GLI-TrainingData/BraTS-GLI-02867-100/BraTS-GLI-02867-100-seg.nii.gz,100,177,86,89,115,148,192,68,112,26,44,44
02105-105,../../DataSet/BraTS2024-BraTS-GLI-TrainingData/BraTS-GLI-02105-105/BraTS-GLI-02105-105-t1c.nii.gz,../../DataSet/BraTS2024-BraTS-GLI-TrainingData/BraTS-GLI-02105-105/BraTS-GLI-02105-105-t2w.nii.gz,../../DataSet/BraTS2024-BraTS-GLI-TrainingData/BraTS-GLI-02105-105/BraTS-GLI-02105-105-t2f.nii.gz,../../DataSet/BraTS2024-BraTS-GLI-TrainingData/BraTS-GLI-02105-105/BraTS-GLI-02105-105-t1n.nii.gz,../../DataSet/BraTS2024-BraTS-GLI-TrainingData/BraTS-GLI-02105-105/BraTS-GLI-02105-105-seg.nii.gz,67,81,108,43,104,43,118,68,152,61,75,84
02363-100,../../DataSet/BraTS2024-BraTS-GLI-TrainingData/BraTS-GLI-02363-100/BraTS-GLI-02363-100-t1c.nii.gz,../../DataSet/BraTS2024-BraTS-GLI-TrainingData/BraTS-GLI-02363-100/BraTS-GLI-02363-100-t2w.nii.gz,../../DataSet/BraTS2024-BraTS-GLI-TrainingData/BraTS-GLI-02363-100/BraTS-GLI-02363-100-t2f.nii.gz,../../DataSet/BraTS2024-BraTS-GLI-TrainingData/BraTS-GLI-02363-100/BraTS-GLI-02363-100-t1n.nii.gz,../../DataSet/BraTS2024-BraTS-GLI-TrainingData/BraTS-GLI-02363-100/BraTS-GLI-02363-100-seg.nii.gz,74,139,133,58,91,116,175,110,156,33,59,46
02934-101,../../DataSet/BraTS2024-BraTS-GLI-TrainingData/BraTS-GLI-02934-101/BraTS-GLI-02934-101-t1c.nii.gz,../../DataSet/BraTS2024-BraTS-GLI-TrainingData/BraTS-GLI-02934-101/BraTS-GLI-02934-101-t2w.nii.gz,../../DataSet/BraTS2024-BraTS-GLI-TrainingData/BraTS-GLI-02934-101/BraTS-GLI-02934-101-t2f.nii.gz,../../DataSet/BraTS2024-BraTS-GLI-TrainingData/BraTS-GLI-02934-101/BraTS-GLI-02934-101-t1n.nii.gz,../../DataSet/BraTS2024-BraTS-GLI-TrainingData/BraTS-GLI-02934-101/BraTS-GLI-02934-101-seg.nii.gz,110,74,125,95,134,45,101,98,152,39,56,54
02204-102,../../DataSet/BraTS2024-BraTS-GLI-TrainingData/BraTS-GLI-02204-102/BraTS-GLI-02204-102-t1c.nii.gz,../../DataSet/BraTS2024-BraTS-GLI-TrainingData/BraTS-GLI-02204-102/BraTS-GLI-02204-102-t2w.nii.gz,../../DataSet/BraTS2024-BraTS-GLI-TrainingData/BraTS-GLI-02204-102/BraTS-GLI-02204-102-t2f.nii.gz,../../DataSet/BraTS2024-BraTS-GLI-TrainingData/BraTS-GLI-02204-102/BraTS-GLI-02204-102-t1n.nii.gz,../../DataSet/BraTS2024-BraTS-GLI-TrainingData/BraTS-GLI-02204-102/BraTS-GLI-02204-102-seg.nii.gz,72,132,62,46,100,105,160,44,85,54,55,41
02938-100,../../DataSet/BraTS2024-BraTS-GLI-TrainingData/BraTS-GLI-02938-100/BraTS-GLI-02938-100-t1c.nii.gz,../../DataSet/BraTS2024-BraTS-GLI-TrainingData/BraTS-GLI-02938-100/BraTS-GLI-02938-100-t2w.nii.gz,../../DataSet/BraTS2024-BraTS-GLI-TrainingData/BraTS-GLI-02938-100/BraTS-GLI-02938-100-t2f.nii.gz,../../DataSet/BraTS2024-BraTS-GLI-TrainingData/BraTS-GLI-02938-100/BraTS-GLI-02938-100-t1n.nii.gz,../../DataSet/BraTS2024-BraTS-GLI-TrainingData/BraTS-GLI-02938-100/BraTS-GLI-02938-100-seg.nii.gz,118,160,92,93,150,129,190,60,133,57,61,73
02237-101,../../DataSet/BraTS2024-BraTS-GLI-TrainingData/BraTS-GLI-02237-101/BraTS-GLI-02237-101-t1c.nii.gz,../../DataSet/BraTS2024-BraTS-GLI-TrainingData/BraTS-GLI-02237-101/BraTS-GLI-02237-101-t2w.nii.gz,../../DataSet/BraTS2024-BraTS-GLI-TrainingData/BraTS-GLI-02237-101/BraTS-GLI-02237-101-t2f.nii.gz,../../DataSet/BraTS2024-BraTS-GLI-TrainingData/BraTS-GLI-02237-101/BraTS-GLI-02237-101-t1n.nii.gz,../../DataSet/BraTS2024-BraTS-GLI-TrainingData/BraTS-GLI-02237-101/BraTS-GLI-02237-101-seg.nii.gz,76,152,111,53,134,109,193,76,146,81,84,70
02860-100,../../DataSet/BraTS2024-BraTS-GLI-TrainingData/BraTS-GLI-02860-100/BraTS-GLI-02860-100-t1c.nii.gz,../../DataSet/BraTS2024-BraTS-GLI-TrainingData/BraTS-GLI-02860-100/BraTS-GLI-02860-100-t2w.nii.gz,../../DataSet/BraTS2024-BraTS-GLI-TrainingData/BraTS-GLI-02860-100/BraTS-GLI-02860-100-t2f.nii.gz,../../DataSet/BraTS2024-BraTS-GLI-TrainingData/BraTS-GLI-02860-100/BraTS-GLI-02860-100-t1n.nii.gz,../../DataSet/BraTS2024-BraTS-GLI-TrainingData/BraTS-GLI-02860-100/BraTS-GLI-02860-100-seg.nii.gz,64,141,97,45,85,115,169,74,121,40,54,47
02933-101,../../DataSet/BraTS2024-BraTS-GLI-TrainingData/BraTS-GLI-02933-101/BraTS-GLI-02933-101-t1c.nii.gz,../../DataSet/BraTS2024-BraTS-GLI-TrainingData/BraTS-GLI-02933-101/BraTS-GLI-02933-101-t2w.nii.gz,../../DataSet/BraTS2024-BraTS-GLI-TrainingData/BraTS-GLI-02933-101/BraTS-GLI-02933-101-t2f.nii.gz,../../DataSet/BraTS2024-BraTS-GLI-TrainingData/BraTS-GLI-02933-101/BraTS-GLI-02933-101-t1n.nii.gz,../../DataSet/BraTS2024-BraTS-GLI-TrainingData/BraTS-GLI-02933-101/BraTS-GLI-02933-101-seg.nii.gz,73,154,102,45,120,108,186,71,136,75,78,65
02995-100,../../DataSet/BraTS2024-BraTS-GLI-TrainingData/BraTS-GLI-02995-100/BraTS-GLI-02995-100-t1c.nii.gz,../../DataSet/BraTS2024-BraTS-GLI-TrainingData/BraTS-GLI-02995-100/BraTS-GLI-02995-100-t2w.nii.gz,../../DataSet/BraTS2024-BraTS-GLI-TrainingData/BraTS-GLI-02995-100/BraTS-GLI-02995-100-t2f.nii.gz,../../DataSet/BraTS2024-BraTS-GLI-TrainingData/BraTS-GLI-02995-100/BraTS-GLI-02995-100-t1n.nii.gz,../../DataSet/BraTS2024-BraTS-GLI-TrainingData/BraTS-GLI-02995-100/BraTS-GLI-02995-100-seg.nii.gz,99,105,124,64,133,59,153,87,160,69,94,73
02240-100,../../DataSet/BraTS2024-BraTS-GLI-TrainingData/BraTS-GLI-02240-100/BraTS-GLI-02240-100-t1c.nii.gz,../../DataSet/BraTS2024-BraTS-GLI-TrainingData/BraTS-GLI-02240-100/BraTS-GLI-02240-100-t2w.nii.gz,../../DataSet/BraTS2024-BraTS-GLI-TrainingData/BraTS-GLI-02240-100/BraTS-GLI-02240-100-t2f.nii.gz,../../DataSet/BraTS2024-BraTS-GLI-TrainingData/BraTS-GLI-02240-100/BraTS-GLI-02240-100-t1n.nii.gz,../../DataSet/BraTS2024-BraTS-GLI-TrainingData/BraTS-GLI-02240-100/BraTS-GLI-02240-100-seg.nii.gz,98,162,78,64,124,132,196,50,106,60,64,56
02186-100,../../DataSet/BraTS2024-BraTS-GLI-TrainingData/BraTS-GLI-02186-100/BraTS-GLI-02186-100-t1c.nii.gz,../../DataSet/BraTS2024-BraTS-GLI-TrainingData/BraTS-GLI-02186-100/BraTS-GLI-02186-100-t2w.nii.gz,../../DataSet/BraTS2024-BraTS-GLI-TrainingData/BraTS-GLI-02186-100/BraTS-GLI-02186-100-t2f.nii.gz,../../DataSet/BraTS2024-BraTS-GLI-TrainingData/BraTS-GLI-02186-100/BraTS-GLI-02186-100-t1n.nii.gz,../../DataSet/BraTS2024-BraTS-GLI-TrainingData/BraTS-GLI-02186-100/BraTS-GLI-02186-100-seg.nii.gz,120,111,112,102,142,65,149,75,145,40,84,70
03061-100,../../DataSet/BraTS2024-BraTS-GLI-TrainingData/BraTS-GLI-03061-100/BraTS-GLI-03061-100-t1c.nii.gz,../../DataSet/BraTS2024-BraTS-GLI-TrainingData/BraTS-GLI-03061-100/BraTS-GLI-03061-100-t2w.nii.gz,../../DataSet/BraTS2024-BraTS-GLI-TrainingData/BraTS-GLI-03061-100/BraTS-GLI-03061-100-t2f.nii.gz,../../DataSet/BraTS2024-BraTS-GLI-TrainingData/BraTS-GLI-03061-100/BraTS-GLI-03061-100-t1n.nii.gz,../../DataSet/BraTS2024-BraTS-GLI-TrainingData/BraTS-GLI-03061-100/BraTS-GLI-03061-100-seg.nii.gz,113,123,86,79,144,81,168,46,124,65,87,78
02772-101,../../DataSet/BraTS2024-BraTS-GLI-TrainingData/BraTS-GLI-02772-101/BraTS-GLI-02772-101-t1c.nii.gz,../../DataSet/BraTS2024-BraTS-GLI-TrainingData/BraTS-GLI-02772-101/BraTS-GLI-02772-101-t2w.nii.gz,../../DataSet/BraTS2024-BraTS-GLI-TrainingData/BraTS-GLI-02772-101/BraTS-GLI-02772-101-t2f.nii.gz,../../DataSet/BraTS2024-BraTS-GLI-TrainingData/BraTS-GLI-02772-101/BraTS-GLI-02772-101-t1n.nii.gz,../../DataSet/BraTS2024-BraTS-GLI-TrainingData/BraTS-GLI-02772-101/BraTS-GLI-02772-101-seg.nii.gz,129,66,87,104,156,31,101,55,126,52,70,71
00027-101,../../DataSet/BraTS2024-BraTS-GLI-TrainingData/BraTS-GLI-00027-101/BraTS-GLI-00027-101-t1c.nii.gz,../../DataSet/BraTS2024-BraTS-GLI-TrainingData/BraTS-GLI-00027-101/BraTS-GLI-00027-101-t2w.nii.gz,../../DataSet/BraTS2024-BraTS-GLI-TrainingData/BraTS-GLI-00027-101/BraTS-GLI-00027-101-t2f.nii.gz,../../DataSet/BraTS2024-BraTS-GLI-TrainingData/BraTS-GLI-00027-101/BraTS-GLI-00027-101-t1n.nii.gz,../../DataSet/BraTS2024-BraTS-GLI-TrainingData/BraTS-GLI-00027-101/BraTS-GLI-00027-101-seg.nii.gz,110,55,91,89,138,26,108,57,118,49,82,61
02608-105,../../DataSet/BraTS2024-BraTS-GLI-TrainingData/BraTS-GLI-02608-105/BraTS-GLI-02608-105-t1c.nii.gz,../../DataSet/BraTS2024-BraTS-GLI-TrainingData/BraTS-GLI-02608-105/BraTS-GLI-02608-105-t2w.nii.gz,../../DataSet/BraTS2024-BraTS-GLI-TrainingData/BraTS-GLI-02608-105/BraTS-GLI-02608-105-t2f.nii.gz,../../DataSet/BraTS2024-BraTS-GLI-TrainingData/BraTS-GLI-02608-105/BraTS-GLI-02608-105-t1n.nii.gz,../../DataSet/BraTS2024-BraTS-GLI-TrainingData/BraTS-GLI-02608-105/BraTS-GLI-02608-105-seg.nii.gz,110,61,105,67,139,33,98,72,139,72,65,67
02164-103,../../DataSet/BraTS2024-BraTS-GLI-TrainingData/BraTS-GLI-02164-103/BraTS-GLI-02164-103-t1c.nii.gz,../../DataSet/BraTS2024-BraTS-GLI-TrainingData/BraTS-GLI-02164-103/BraTS-GLI-02164-103-t2w.nii.gz,../../DataSet/BraTS2024-BraTS-GLI-TrainingData/BraTS-GLI-02164-103/BraTS-GLI-02164-103-t2f.nii.gz,../../DataSet/BraTS2024-BraTS-GLI-TrainingData/BraTS-GLI-02164-103/BraTS-GLI-02164-103-t1n.nii.gz,../../DataSet/BraTS2024-BraTS-GLI-TrainingData/BraTS-GLI-02164-103/BraTS-GLI-02164-103-seg.nii.gz,130,79,111,108,153,49,123,78,138,45,74,60
02779-100,../../DataSet/BraTS2024-BraTS-GLI-TrainingData/BraTS-GLI-02779-100/BraTS-GLI-02779-100-t1c.nii.gz,../../DataSet/BraTS2024-BraTS-GLI-TrainingData/BraTS-GLI-02779-100/BraTS-GLI-02779-100-t2w.nii.gz,../../DataSet/BraTS2024-BraTS-GLI-TrainingData/BraTS-GLI-02779-100/BraTS-GLI-02779-100-t2f.nii.gz,../../DataSet/BraTS2024-BraTS-GLI-TrainingData/BraTS-GLI-02779-100/BraTS-GLI-02779-100-t1n.nii.gz,../../DataSet/BraTS2024-BraTS-GLI-TrainingData/BraTS-GLI-02779-100/BraTS-GLI-02779-100-seg.nii.gz,75,123,133,55,105,103,151,111,155,50,48,44
02547-102,../../DataSet/BraTS2024-BraTS-GLI-TrainingData/BraTS-GLI-02547-102/BraTS-GLI-02547-102-t1c.nii.gz,../../DataSet/BraTS2024-BraTS-GLI-TrainingData/BraTS-GLI-02547-102/BraTS-GLI-02547-102-t2w.nii.gz,../../DataSet/BraTS2024-BraTS-GLI-TrainingData/BraTS-GLI-02547-102/BraTS-GLI-02547-102-t2f.nii.gz,../../DataSet/BraTS2024-BraTS-GLI-TrainingData/BraTS-GLI-02547-102/BraTS-GLI-02547-102-t1n.nii.gz,../../DataSet/BraTS2024-BraTS-GLI-TrainingData/BraTS-GLI-02547-102/BraTS-GLI-02547-102-seg.nii.gz,72,92,115,42,110,52,138,87,145,68,86,58
02209-100,../../DataSet/BraTS2024-BraTS-GLI-TrainingData/BraTS-GLI-02209-100/BraTS-GLI-02209-100-t1c.nii.gz,../../DataSet/BraTS2024-BraTS-GLI-TrainingData/BraTS-GLI-02209-100/BraTS-GLI-02209-100-t2w.nii.gz,../../DataSet/BraTS2024-BraTS-GLI-TrainingData/BraTS-GLI-02209-100/BraTS-GLI-02209-100-t2f.nii.gz,../../DataSet/BraTS2024-BraTS-GLI-TrainingData/BraTS-GLI-02209-100/BraTS-GLI-02209-100-t1n.nii.gz,../../DataSet/BraTS2024-BraTS-GLI-TrainingData/BraTS-GLI-02209-100/BraTS-GLI-02209-100-seg.nii.gz,55,136,90,35,82,111,167,64,121,47,56,57
02115-101,../../DataSet/BraTS2024-BraTS-GLI-TrainingData/BraTS-GLI-02115-101/BraTS-GLI-02115-101-t1c.nii.gz,../../DataSet/BraTS2024-BraTS-GLI-TrainingData/BraTS-GLI-02115-101/BraTS-GLI-02115-101-t2w.nii.gz,../../DataSet/BraTS2024-BraTS-GLI-TrainingData/BraTS-GLI-02115-101/BraTS-GLI-02115-101-t2f.nii.gz,../../DataSet/BraTS2024-BraTS-GLI-TrainingData/BraTS-GLI-02115-101/BraTS-GLI-02115-101-t1n.nii.gz,../../DataSet/BraTS2024-BraTS-GLI-TrainingData/BraTS-GLI-02115-101/BraTS-GLI-02115-101-seg.nii.gz,56,60,74,44,75,42,109,57,120,31,67,63
02884-100,../../DataSet/BraTS2024-BraTS-GLI-TrainingData/BraTS-GLI-02884-100/BraTS-GLI-02884-100-t1c.nii.gz,../../DataSet/BraTS2024-BraTS-GLI-TrainingData/BraTS-GLI-02884-100/BraTS-GLI-02884-100-t2w.nii.gz,../../DataSet/BraTS2024-BraTS-GLI-TrainingData/BraTS-GLI-02884-100/BraTS-GLI-02884-100-t2f.nii.gz,../../DataSet/BraTS2024-BraTS-GLI-TrainingData/BraTS-GLI-02884-100/BraTS-GLI-02884-100-t1n.nii.gz,../../DataSet/BraTS2024-BraTS-GLI-TrainingData/BraTS-GLI-02884-100/BraTS-GLI-02884-100-seg.nii.gz,59,55,84,31,85,28,105,51,125,54,77,74
02855-100,../../DataSet/BraTS2024-BraTS-GLI-TrainingData/BraTS-GLI-02855-100/BraTS-GLI-02855-100-t1c.nii.gz,../../DataSet/BraTS2024-BraTS-GLI-TrainingData/BraTS-GLI-02855-100/BraTS-GLI-02855-100-t2w.nii.gz,../../DataSet/BraTS2024-BraTS-GLI-TrainingData/BraTS-GLI-02855-100/BraTS-GLI-02855-100-t2f.nii.gz,../../DataSet/BraTS2024-BraTS-GLI-TrainingData/BraTS-GLI-02855-100/BraTS-GLI-02855-100-t1n.nii.gz,../../DataSet/BraTS2024-BraTS-GLI-TrainingData/BraTS-GLI-02855-100/BraTS-GLI-02855-100-seg.nii.gz,72,64,97,47,116,37,120,59,125,69,83,66
00557-101,../../DataSet/BraTS2024-BraTS-GLI-TrainingData/BraTS-GLI-00557-101/BraTS-GLI-00557-101-t1c.nii.gz,../../DataSet/BraTS2024-BraTS-GLI-TrainingData/BraTS-GLI-00557-101/BraTS-GLI-00557-101-t2w.nii.gz,../../DataSet/BraTS2024-BraTS-GLI-TrainingData/BraTS-GLI-00557-101/BraTS-GLI-00557-101-t2f.nii.gz,../../DataSet/BraTS2024-BraTS-GLI-TrainingData/BraTS-GLI-00557-101/BraTS-GLI-00557-101-t1n.nii.gz,../../DataSet/BraTS2024-BraTS-GLI-TrainingData/BraTS-GLI-00557-101/BraTS-GLI-00557-101-seg.nii.gz,64,112,107,32,112,70,154,76,139,80,84,63
02162-100,../../DataSet/BraTS2024-BraTS-GLI-TrainingData/BraTS-GLI-02162-100/BraTS-GLI-02162-100-t1c.nii.gz,../../DataSet/BraTS2024-BraTS-GLI-TrainingData/BraTS-GLI-02162-100/BraTS-GLI-02162-100-t2w.nii.gz,../../DataSet/BraTS2024-BraTS-GLI-TrainingData/BraTS-GLI-02162-100/BraTS-GLI-02162-100-t2f.nii.gz,../../DataSet/BraTS2024-BraTS-GLI-TrainingData/BraTS-GLI-02162-100/BraTS-GLI-02162-100-t1n.nii.gz,../../DataSet/BraTS2024-BraTS-GLI-TrainingData/BraTS-GLI-02162-100/BraTS-GLI-02162-100-seg.nii.gz,120,107,117,107,143,62,141,91,140,36,79,49
02747-101,../../DataSet/BraTS2024-BraTS-GLI-TrainingData/BraTS-GLI-02747-101/BraTS-GLI-02747-101-t1c.nii.gz,../../DataSet/BraTS2024-BraTS-GLI-TrainingData/BraTS-GLI-02747-101/BraTS-GLI-02747-101-t2w.nii.gz,../../DataSet/BraTS2024-BraTS-GLI-TrainingData/BraTS-GLI-02747-101/BraTS-GLI-02747-101-t2f.nii.gz,../../DataSet/BraTS2024-BraTS-GLI-TrainingData/BraTS-GLI-02747-101/BraTS-GLI-02747-101-t1n.nii.gz,../../DataSet/BraTS2024-BraTS-GLI-TrainingData/BraTS-GLI-02747-101/BraTS-GLI-02747-101-seg.nii.gz,77,156,104,57,98,127,195,66,136,41,68,70
02796-101,../../DataSet/BraTS2024-BraTS-GLI-TrainingData/BraTS-GLI-02796-101/BraTS-GLI-02796-101-t1c.nii.gz,../../DataSet/BraTS2024-BraTS-GLI-TrainingData/BraTS-GLI-02796-101/BraTS-GLI-02796-101-t2w.nii.gz,../../DataSet/BraTS2024-BraTS-GLI-TrainingData/BraTS-GLI-02796-101/BraTS-GLI-02796-101-t2f.nii.gz,../../DataSet/BraTS2024-BraTS-GLI-TrainingData/BraTS-GLI-02796-101/BraTS-GLI-02796-101-t1n.nii.gz,../../DataSet/BraTS2024-BraTS-GLI-TrainingData/BraTS-GLI-02796-101/BraTS-GLI-02796-101-seg.nii.gz,119,87,119,96,151,44,137,90,150,55,93,60
03054-100,../../DataSet/BraTS2024-BraTS-GLI-TrainingData/BraTS-GLI-03054-100/BraTS-GLI-03054-100-t1c.nii.gz,../../DataSet/BraTS2024-BraTS-GLI-TrainingData/BraTS-GLI-03054-100/BraTS-GLI-03054-100-t2w.nii.gz,../../DataSet/BraTS2024-BraTS-GLI-TrainingData/BraTS-GLI-03054-100/BraTS-GLI-03054-100-t2f.nii.gz,../../DataSet/BraTS2024-BraTS-GLI-TrainingData/BraTS-GLI-03054-100/BraTS-GLI-03054-100-t1n.nii.gz,../../DataSet/BraTS2024-BraTS-GLI-TrainingData/BraTS-GLI-03054-100/BraTS-GLI-03054-100-seg.nii.gz,128,90,104,94,155,57,127,76,140,61,70,64
02829-100,../../DataSet/BraTS2024-BraTS-GLI-TrainingData/BraTS-GLI-02829-100/BraTS-GLI-02829-100-t1c.nii.gz,../../DataSet/BraTS2024-BraTS-GLI-TrainingData/BraTS-GLI-02829-100/BraTS-GLI-02829-100-t2w.nii.gz,../../DataSet/BraTS2024-BraTS-GLI-TrainingData/BraTS-GLI-02829-100/BraTS-GLI-02829-100-t2f.nii.gz,../../DataSet/BraTS2024-BraTS-GLI-TrainingData/BraTS-GLI-02829-100/BraTS-GLI-02829-100-t1n.nii.gz,../../DataSet/BraTS2024-BraTS-GLI-TrainingData/BraTS-GLI-02829-100/BraTS-GLI-02829-100-seg.nii.gz,68,65,104,32,120,30,123,64,143,88,93,79
02196-104,../../DataSet/BraTS2024-BraTS-GLI-TrainingData/BraTS-GLI-02196-104/BraTS-GLI-02196-104-t1c.nii.gz,../../DataSet/BraTS2024-BraTS-GLI-TrainingData/BraTS-GLI-02196-104/BraTS-GLI-02196-104-t2w.nii.gz,../../DataSet/BraTS2024-BraTS-GLI-TrainingData/BraTS-GLI-02196-104/BraTS-GLI-02196-104-t2f.nii.gz,../../DataSet/BraTS2024-BraTS-GLI-TrainingData/BraTS-GLI-02196-104/BraTS-GLI-02196-104-t1n.nii.gz,../../DataSet/BraTS2024-BraTS-GLI-TrainingData/BraTS-GLI-02196-104/BraTS-GLI-02196-104-seg.nii.gz,85,150,108,41,125,105,192,67,146,84,87,79
02165-100,../../DataSet/BraTS2024-BraTS-GLI-TrainingData/BraTS-GLI-02165-100/BraTS-GLI-02165-100-t1c.nii.gz,../../DataSet/BraTS2024-BraTS-GLI-TrainingData/BraTS-GLI-02165-100/BraTS-GLI-02165-100-t2w.nii.gz,../../DataSet/BraTS2024-BraTS-GLI-TrainingData/BraTS-GLI-02165-100/BraTS-GLI-02165-100-t2f.nii.gz,../../DataSet/BraTS2024-BraTS-GLI-TrainingData/BraTS-GLI-02165-100/BraTS-GLI-02165-100-t1n.nii.gz,../../DataSet/BraTS2024-BraTS-GLI-TrainingData/BraTS-GLI-02165-100/BraTS-GLI-02165-100-seg.nii.gz,53,117,63,30,75,87,145,46,87,45,58,41
03053-100,../../DataSet/BraTS2024-BraTS-GLI-TrainingData/BraTS-GLI-03053-100/BraTS-GLI-03053-100-t1c.nii.gz,../../DataSet/BraTS2024-BraTS-GLI-TrainingData/BraTS-GLI-03053-100/BraTS-GLI-03053-100-t2w.nii.gz,../../DataSet/BraTS2024-BraTS-GLI-TrainingData/BraTS-GLI-03053-100/BraTS-GLI-03053-100-t2f.nii.gz,../../DataSet/BraTS2024-BraTS-GLI-TrainingData/BraTS-GLI-03053-100/BraTS-GLI-03053-100-t1n.nii.gz,../../DataSet/BraTS2024-BraTS-GLI-TrainingData/BraTS-GLI-03053-100/BraTS-GLI-03053-100-seg.nii.gz,114,136,112,69,143,106,172,86,140,74,66,54
02072-103,../../DataSet/BraTS2024-BraTS-GLI-TrainingData/BraTS-GLI-02072-103/BraTS-GLI-02072-103-t1c.nii.gz,../../DataSet/BraTS2024-BraTS-GLI-TrainingData/BraTS-GLI-02072-103/BraTS-GLI-02072-103-t2w.nii.gz,../../DataSet/BraTS2024-BraTS-GLI-TrainingData/BraTS-GLI-02072-103/BraTS-GLI-02072-103-t2f.nii.gz,../../DataSet/BraTS2024-BraTS-GLI-TrainingData/BraTS-GLI-02072-103/BraTS-GLI-02072-103-t1n.nii.gz,../../DataSet/BraTS2024-BraTS-GLI-TrainingData/BraTS-GLI-02072-103/BraTS-GLI-02072-103-seg.nii.gz,54,112,87,29,92,75,153,44,139,63,78,95
02236-102,../../DataSet/BraTS2024-BraTS-GLI-TrainingData/BraTS-GLI-02236-102/BraTS-GLI-02236-102-t1c.nii.gz,../../DataSet/BraTS2024-BraTS-GLI-TrainingData/BraTS-GLI-02236-102/BraTS-GLI-02236-102-t2w.nii.gz,../../DataSet/BraTS2024-BraTS-GLI-TrainingData/BraTS-GLI-02236-102/BraTS-GLI-02236-102-t2f.nii.gz,../../DataSet/BraTS2024-BraTS-GLI-TrainingData/BraTS-GLI-02236-102/BraTS-GLI-02236-102-t1n.nii.gz,../../DataSet/BraTS2024-BraTS-GLI-TrainingData/BraTS-GLI-02236-102/BraTS-GLI-02236-102-seg.nii.gz,131,129,92,115,149,106,150,70,111,34,44,41
02112-101,../../DataSet/BraTS2024-BraTS-GLI-TrainingData/BraTS-GLI-02112-101/BraTS-GLI-02112-101-t1c.nii.gz,../../DataSet/BraTS2024-BraTS-GLI-TrainingData/BraTS-GLI-02112-101/BraTS-GLI-02112-101-t2w.nii.gz,../../DataSet/BraTS2024-BraTS-GLI-TrainingData/BraTS-GLI-02112-101/BraTS-GLI-02112-101-t2f.nii.gz,../../DataSet/BraTS2024-BraTS-GLI-TrainingData/BraTS-GLI-02112-101/BraTS-GLI-02112-101-t1n.nii.gz,../../DataSet/BraTS2024-BraTS-GLI-TrainingData/BraTS-GLI-02112-101/BraTS-GLI-02112-101-seg.nii.gz,64,63,112,37,87,33,117,75,151,50,84,76
02901-101,../../DataSet/BraTS2024-BraTS-GLI-TrainingData/BraTS-GLI-02901-101/BraTS-GLI-02901-101-t1c.nii.gz,../../DataSet/BraTS2024-BraTS-GLI-TrainingData/BraTS-GLI-02901-101/BraTS-GLI-02901-101-t2w.nii.gz,../../DataSet/BraTS2024-BraTS-GLI-TrainingData/BraTS-GLI-02901-101/BraTS-GLI-02901-101-t2f.nii.gz,../../DataSet/BraTS2024-BraTS-GLI-TrainingData/BraTS-GLI-02901-101/BraTS-GLI-02901-101-t1n.nii.gz,../../DataSet/BraTS2024-BraTS-GLI-TrainingData/BraTS-GLI-02901-101/BraTS-GLI-02901-101-seg.nii.gz,60,126,123,45,90,92,147,100,139,45,55,39
02852-100,../../DataSet/BraTS2024-BraTS-GLI-TrainingData/BraTS-GLI-02852-100/BraTS-GLI-02852-100-t1c.nii.gz,../../DataSet/BraTS2024-BraTS-GLI-TrainingData/BraTS-GLI-02852-100/BraTS-GLI-02852-100-t2w.nii.gz,../../DataSet/BraTS2024-BraTS-GLI-TrainingData/BraTS-GLI-02852-100/BraTS-GLI-02852-100-t2f.nii.gz,../../DataSet/BraTS2024-BraTS-GLI-TrainingData/BraTS-GLI-02852-100/BraTS-GLI-02852-100-t1n.nii.gz,../../DataSet/BraTS2024-BraTS-GLI-TrainingData/BraTS-GLI-02852-100/BraTS-GLI-02852-100-seg.nii.gz,119,117,90,71,153,87,152,45,127,82,65,82
02205-101,../../DataSet/BraTS2024-BraTS-GLI-TrainingData/BraTS-GLI-02205-101/BraTS-GLI-02205-101-t1c.nii.gz,../../DataSet/BraTS2024-BraTS-GLI-TrainingData/BraTS-GLI-02205-101/BraTS-GLI-02205-101-t2w.nii.gz,../../DataSet/BraTS2024-BraTS-GLI-TrainingData/BraTS-GLI-02205-101/BraTS-GLI-02205-101-t2f.nii.gz,../../DataSet/BraTS2024-BraTS-GLI-TrainingData/BraTS-GLI-02205-101/BraTS-GLI-02205-101-t1n.nii.gz,../../DataSet/BraTS2024-BraTS-GLI-TrainingData/BraTS-GLI-02205-101/BraTS-GLI-02205-101-seg.nii.gz,100,146,117,90,117,116,179,78,150,27,63,72
03024-101,../../DataSet/BraTS2024-BraTS-GLI-TrainingData/BraTS-GLI-03024-101/BraTS-GLI-03024-101-t1c.nii.gz,../../DataSet/BraTS2024-BraTS-GLI-TrainingData/BraTS-GLI-03024-101/BraTS-GLI-03024-101-t2w.nii.gz,../../DataSet/BraTS2024-BraTS-GLI-TrainingData/BraTS-GLI-03024-101/BraTS-GLI-03024-101-t2f.nii.gz,../../DataSet/BraTS2024-BraTS-GLI-TrainingData/BraTS-GLI-03024-101/BraTS-GLI-03024-101-t1n.nii.gz,../../DataSet/BraTS2024-BraTS-GLI-TrainingData/BraTS-GLI-03024-101/BraTS-GLI-03024-101-seg.nii.gz,124,97,124,105,146,72,126,97,150,41,54,53
02198-104,../../DataSet/BraTS2024-BraTS-GLI-TrainingData/BraTS-GLI-02198-104/BraTS-GLI-02198-104-t1c.nii.gz,../../DataSet/BraTS2024-BraTS-GLI-TrainingData/BraTS-GLI-02198-104/BraTS-GLI-02198-104-t2w.nii.gz,../../DataSet/BraTS2024-BraTS-GLI-TrainingData/BraTS-GLI-02198-104/BraTS-GLI-02198-104-t2f.nii.gz,../../DataSet/BraTS2024-BraTS-GLI-TrainingData/BraTS-GLI-02198-104/BraTS-GLI-02198-104-t1n.nii.gz,../../DataSet/BraTS2024-BraTS-GLI-TrainingData/BraTS-GLI-02198-104/BraTS-GLI-02198-104-seg.nii.gz,59,64,92,32,122,28,114,62,126,90,86,64
02978-100,../../DataSet/BraTS2024-BraTS-GLI-TrainingData/BraTS-GLI-02978-100/BraTS-GLI-02978-100-t1c.nii.gz,../../DataSet/BraTS2024-BraTS-GLI-TrainingData/BraTS-GLI-02978-100/BraTS-GLI-02978-100-t2w.nii.gz,../../DataSet/BraTS2024-BraTS-GLI-TrainingData/BraTS-GLI-02978-100/BraTS-GLI-02978-100-t2f.nii.gz,../../DataSet/BraTS2024-BraTS-GLI-TrainingData/BraTS-GLI-02978-100/BraTS-GLI-02978-100-t1n.nii.gz,../../DataSet/BraTS2024-BraTS-GLI-TrainingData/BraTS-GLI-02978-100/BraTS-GLI-02978-100-seg.nii.gz,48,120,60,25,75,60,153,40,86,50,93,46
02244-102,../../DataSet/BraTS2024-BraTS-GLI-TrainingData/BraTS-GLI-02244-102/BraTS-GLI-02244-102-t1c.nii.gz,../../DataSet/BraTS2024-BraTS-GLI-TrainingData/BraTS-GLI-02244-102/BraTS-GLI-02244-102-t2w.nii.gz,../../DataSet/BraTS2024-BraTS-GLI-TrainingData/BraTS-GLI-02244-102/BraTS-GLI-02244-102-t2f.nii.gz,../../DataSet/BraTS2024-BraTS-GLI-TrainingData/BraTS-GLI-02244-102/BraTS-GLI-02244-102-t1n.nii.gz,../../DataSet/BraTS2024-BraTS-GLI-TrainingData/BraTS-GLI-02244-102/BraTS-GLI-02244-102-seg.nii.gz,71,142,106,47,90,108,182,65,143,43,74,78
02149-104,../../DataSet/BraTS2024-BraTS-GLI-TrainingData/BraTS-GLI-02149-104/BraTS-GLI-02149-104-t1c.nii.gz,../../DataSet/BraTS2024-BraTS-GLI-TrainingData/BraTS-GLI-02149-104/BraTS-GLI-02149-104-t2w.nii.gz,../../DataSet/BraTS2024-BraTS-GLI-TrainingData/BraTS-GLI-02149-104/BraTS-GLI-02149-104-t2f.nii.gz,../../DataSet/BraTS2024-BraTS-GLI-TrainingData/BraTS-GLI-02149-104/BraTS-GLI-02149-104-t1n.nii.gz,../../DataSet/BraTS2024-BraTS-GLI-TrainingData/BraTS-GLI-02149-104/BraTS-GLI-02149-104-seg.nii.gz,105,84,120,65,128,47,127,88,150,63,80,62
00529-100,../../DataSet/BraTS2024-BraTS-GLI-TrainingData/BraTS-GLI-00529-100/BraTS-GLI-00529-100-t1c.nii.gz,../../DataSet/BraTS2024-BraTS-GLI-TrainingData/BraTS-GLI-00529-100/BraTS-GLI-00529-100-t2w.nii.gz,../../DataSet/BraTS2024-BraTS-GLI-TrainingData/BraTS-GLI-00529-100/BraTS-GLI-00529-100-t2f.nii.gz,../../DataSet/BraTS2024-BraTS-GLI-TrainingData/BraTS-GLI-00529-100/BraTS-GLI-00529-100-t1n.nii.gz,../../DataSet/BraTS2024-BraTS-GLI-TrainingData/BraTS-GLI-00529-100/BraTS-GLI-00529-100-seg.nii.gz,124,115,103,104,150,70,163,70,134,46,93,64
02745-100,../../DataSet/BraTS2024-BraTS-GLI-TrainingData/BraTS-GLI-02745-100/BraTS-GLI-02745-100-t1c.nii.gz,../../DataSet/BraTS2024-BraTS-GLI-TrainingData/BraTS-GLI-02745-100/BraTS-GLI-02745-100-t2w.nii.gz,../../DataSet/BraTS2024-BraTS-GLI-TrainingData/BraTS-GLI-02745-100/BraTS-GLI-02745-100-t2f.nii.gz,../../DataSet/BraTS2024-BraTS-GLI-TrainingData/BraTS-GLI-02745-100/BraTS-GLI-02745-100-t1n.nii.gz,../../DataSet/BraTS2024-BraTS-GLI-TrainingData/BraTS-GLI-02745-100/BraTS-GLI-02745-100-seg.nii.gz,62,70,50,43,91,47,103,30,68,48,56,38
02160-101,../../DataSet/BraTS2024-BraTS-GLI-TrainingData/BraTS-GLI-02160-101/BraTS-GLI-02160-101-t1c.nii.gz,../../DataSet/BraTS2024-BraTS-GLI-TrainingData/BraTS-GLI-02160-101/BraTS-GLI-02160-101-t2w.nii.gz,../../DataSet/BraTS2024-BraTS-GLI-TrainingData/BraTS-GLI-02160-101/BraTS-GLI-02160-101-t2f.nii.gz,../../DataSet/BraTS2024-BraTS-GLI-TrainingData/BraTS-GLI-02160-101/BraTS-GLI-02160-101-t1n.nii.gz,../../DataSet/BraTS2024-BraTS-GLI-TrainingData/BraTS-GLI-02160-101/BraTS-GLI-02160-101-seg.nii.gz,112,59,88,56,145,20,115,58,129,89,95,71
02193-105,../../DataSet/BraTS2024-BraTS-GLI-TrainingData/BraTS-GLI-02193-105/BraTS-GLI-02193-105-t1c.nii.gz,../../DataSet/BraTS2024-BraTS-GLI-TrainingData/BraTS-GLI-02193-105/BraTS-GLI-02193-105-t2w.nii.gz,../../DataSet/BraTS2024-BraTS-GLI-TrainingData/BraTS-GLI-02193-105/BraTS-GLI-02193-105-t2f.nii.gz,../../DataSet/BraTS2024-BraTS-GLI-TrainingData/BraTS-GLI-02193-105/BraTS-GLI-02193-105-t1n.nii.gz,../../DataSet/BraTS2024-BraTS-GLI-TrainingData/BraTS-GLI-02193-105/BraTS-GLI-02193-105-seg.nii.gz,129,87,112,99,156,43,127,76,146,57,84,70
02973-101,../../DataSet/BraTS2024-BraTS-GLI-TrainingData/BraTS-GLI-02973-101/BraTS-GLI-02973-101-t1c.nii.gz,../../DataSet/BraTS2024-BraTS-GLI-TrainingData/BraTS-GLI-02973-101/BraTS-GLI-02973-101-t2w.nii.gz,../../DataSet/BraTS2024-BraTS-GLI-TrainingData/BraTS-GLI-02973-101/BraTS-GLI-02973-101-t2f.nii.gz,../../DataSet/BraTS2024-BraTS-GLI-TrainingData/BraTS-GLI-02973-101/BraTS-GLI-02973-101-t1n.nii.gz,../../DataSet/BraTS2024-BraTS-GLI-TrainingData/BraTS-GLI-02973-101/BraTS-GLI-02973-101-seg.nii.gz,118,86,94,64,152,52,123,53,133,88,71,80
02820-100,../../DataSet/BraTS2024-BraTS-GLI-TrainingData/BraTS-GLI-02820-100/BraTS-GLI-02820-100-t1c.nii.gz,../../DataSet/BraTS2024-BraTS-GLI-TrainingData/BraTS-GLI-02820-100/BraTS-GLI-02820-100-t2w.nii.gz,../../DataSet/BraTS2024-BraTS-GLI-TrainingData/BraTS-GLI-02820-100/BraTS-GLI-02820-100-t2f.nii.gz,../../DataSet/BraTS2024-BraTS-GLI-TrainingData/BraTS-GLI-02820-100/BraTS-GLI-02820-100-t1n.nii.gz,../../DataSet/BraTS2024-BraTS-GLI-TrainingData/BraTS-GLI-02820-100/BraTS-GLI-02820-100-seg.nii.gz,78,134,121,45,115,98,176,94,152,70,78,58
02794-100,../../DataSet/BraTS2024-BraTS-GLI-TrainingData/BraTS-GLI-02794-100/BraTS-GLI-02794-100-t1c.nii.gz,../../DataSet/BraTS2024-BraTS-GLI-TrainingData/BraTS-GLI-02794-100/BraTS-GLI-02794-100-t2w.nii.gz,../../DataSet/BraTS2024-BraTS-GLI-TrainingData/BraTS-GLI-02794-100/BraTS-GLI-02794-100-t2f.nii.gz,../../DataSet/BraTS2024-BraTS-GLI-TrainingData/BraTS-GLI-02794-100/BraTS-GLI-02794-100-t1n.nii.gz,../../DataSet/BraTS2024-BraTS-GLI-TrainingData/BraTS-GLI-02794-100/BraTS-GLI-02794-100-seg.nii.gz,125,127,109,100,153,97,155,86,127,53,58,41
02886-101,../../DataSet/BraTS2024-BraTS-GLI-TrainingData/BraTS-GLI-02886-101/BraTS-GLI-02886-101-t1c.nii.gz,../../DataSet/BraTS2024-BraTS-GLI-TrainingData/BraTS-GLI-02886-101/BraTS-GLI-02886-101-t2w.nii.gz,../../DataSet/BraTS2024-BraTS-GLI-TrainingData/BraTS-GLI-02886-101/BraTS-GLI-02886-101-t2f.nii.gz,../../DataSet/BraTS2024-BraTS-GLI-TrainingData/BraTS-GLI-02886-101/BraTS-GLI-02886-101-t1n.nii.gz,../../DataSet/BraTS2024-BraTS-GLI-TrainingData/BraTS-GLI-02886-101/BraTS-GLI-02886-101-seg.nii.gz,71,125,129,53,87,105,151,103,150,34,46,47
02904-100,../../DataSet/BraTS2024-BraTS-GLI-TrainingData/BraTS-GLI-02904-100/BraTS-GLI-02904-100-t1c.nii.gz,../../DataSet/BraTS2024-BraTS-GLI-TrainingData/BraTS-GLI-02904-100/BraTS-GLI-02904-100-t2w.nii.gz,../../DataSet/BraTS2024-BraTS-GLI-TrainingData/BraTS-GLI-02904-100/BraTS-GLI-02904-100-t2f.nii.gz,../../DataSet/BraTS2024-BraTS-GLI-TrainingData/BraTS-GLI-02904-100/BraTS-GLI-02904-100-t1n.nii.gz,../../DataSet/BraTS2024-BraTS-GLI-TrainingData/BraTS-GLI-02904-100/BraTS-GLI-02904-100-seg.nii.gz,73,122,128,58,88,88,149,108,147,30,61,39
02661-100,../../DataSet/BraTS2024-BraTS-GLI-TrainingData/BraTS-GLI-02661-100/BraTS-GLI-02661-100-t1c.nii.gz,../../DataSet/BraTS2024-BraTS-GLI-TrainingData/BraTS-GLI-02661-100/BraTS-GLI-02661-100-t2w.nii.gz,../../DataSet/BraTS2024-BraTS-GLI-TrainingData/BraTS-GLI-02661-100/BraTS-GLI-02661-100-t2f.nii.gz,../../DataSet/BraTS2024-BraTS-GLI-TrainingData/BraTS-GLI-02661-100/BraTS-GLI-02661-100-t1n.nii.gz,../../DataSet/BraTS2024-BraTS-GLI-TrainingData/BraTS-GLI-02661-100/BraTS-GLI-02661-100-seg.nii.gz,131,126,43,107,158,100,155,22,66,51,55,44
03021-100,../../DataSet/BraTS2024-BraTS-GLI-TrainingData/BraTS-GLI-03021-100/BraTS-GLI-03021-100-t1c.nii.gz,../../DataSet/BraTS2024-BraTS-GLI-TrainingData/BraTS-GLI-03021-100/BraTS-GLI-03021-100-t2w.nii.gz,../../DataSet/BraTS2024-BraTS-GLI-TrainingData/BraTS-GLI-03021-100/BraTS-GLI-03021-100-t2f.nii.gz,../../DataSet/BraTS2024-BraTS-GLI-TrainingData/BraTS-GLI-03021-100/BraTS-GLI-03021-100-t1n.nii.gz,../../DataSet/BraTS2024-BraTS-GLI-TrainingData/BraTS-GLI-03021-100/BraTS-GLI-03021-100-seg.nii.gz,62,132,82,47,83,100,167,55,108,36,67,53
02238-102,../../DataSet/BraTS2024-BraTS-GLI-TrainingData/BraTS-GLI-02238-102/BraTS-GLI-02238-102-t1c.nii.gz,../../DataSet/BraTS2024-BraTS-GLI-TrainingData/BraTS-GLI-02238-102/BraTS-GLI-02238-102-t2w.nii.gz,../../DataSet/BraTS2024-BraTS-GLI-TrainingData/BraTS-GLI-02238-102/BraTS-GLI-02238-102-t2f.nii.gz,../../DataSet/BraTS2024-BraTS-GLI-TrainingData/BraTS-GLI-02238-102/BraTS-GLI-02238-102-t1n.nii.gz,../../DataSet/BraTS2024-BraTS-GLI-TrainingData/BraTS-GLI-02238-102/BraTS-GLI-02238-102-seg.nii.gz,74,161,98,49,92,130,200,67,137,43,70,70
02739-100,../../DataSet/BraTS2024-BraTS-GLI-TrainingData/BraTS-GLI-02739-100/BraTS-GLI-02739-100-t1c.nii.gz,../../DataSet/BraTS2024-BraTS-GLI-TrainingData/BraTS-GLI-02739-100/BraTS-GLI-02739-100-t2w.nii.gz,../../DataSet/BraTS2024-BraTS-GLI-TrainingData/BraTS-GLI-02739-100/BraTS-GLI-02739-100-t2f.nii.gz,../../DataSet/BraTS2024-BraTS-GLI-TrainingData/BraTS-GLI-02739-100/BraTS-GLI-02739-100-t1n.nii.gz,../../DataSet/BraTS2024-BraTS-GLI-TrainingData/BraTS-GLI-02739-100/BraTS-GLI-02739-100-seg.nii.gz,75,168,79,59,90,143,191,50,108,31,48,58
02903-100,../../DataSet/BraTS2024-BraTS-GLI-TrainingData/BraTS-GLI-02903-100/BraTS-GLI-02903-100-t1c.nii.gz,../../DataSet/BraTS2024-BraTS-GLI-TrainingData/BraTS-GLI-02903-100/BraTS-GLI-02903-100-t2w.nii.gz,../../DataSet/BraTS2024-BraTS-GLI-TrainingData/BraTS-GLI-02903-100/BraTS-GLI-02903-100-t2f.nii.gz,../../DataSet/BraTS2024-BraTS-GLI-TrainingData/BraTS-GLI-02903-100/BraTS-GLI-02903-100-t1n.nii.gz,../../DataSet/BraTS2024-BraTS-GLI-TrainingData/BraTS-GLI-02903-100/BraTS-GLI-02903-100-seg.nii.gz,48,75,79,25,71,39,121,60,114,46,82,54
02881-101,../../DataSet/BraTS2024-BraTS-GLI-TrainingData/BraTS-GLI-02881-101/BraTS-GLI-02881-101-t1c.nii.gz,../../DataSet/BraTS2024-BraTS-GLI-TrainingData/BraTS-GLI-02881-101/BraTS-GLI-02881-101-t2w.nii.gz,../../DataSet/BraTS2024-BraTS-GLI-TrainingData/BraTS-GLI-02881-101/BraTS-GLI-02881-101-t2f.nii.gz,../../DataSet/BraTS2024-BraTS-GLI-TrainingData/BraTS-GLI-02881-101/BraTS-GLI-02881-101-t1n.nii.gz,../../DataSet/BraTS2024-BraTS-GLI-TrainingData/BraTS-GLI-02881-101/BraTS-GLI-02881-101-seg.nii.gz,87,98,98,52,132,57,147,49,129,80,90,80
02549-102,../../DataSet/BraTS2024-BraTS-GLI-TrainingData/BraTS-GLI-02549-102/BraTS-GLI-02549-102-t1c.nii.gz,../../DataSet/BraTS2024-BraTS-GLI-TrainingData/BraTS-GLI-02549-102/BraTS-GLI-02549-102-t2w.nii.gz,../../DataSet/BraTS2024-BraTS-GLI-TrainingData/BraTS-GLI-02549-102/BraTS-GLI-02549-102-t2f.nii.gz,../../DataSet/BraTS2024-BraTS-GLI-TrainingData/BraTS-GLI-02549-102/BraTS-GLI-02549-102-t1n.nii.gz,../../DataSet/BraTS2024-BraTS-GLI-TrainingData/BraTS-GLI-02549-102/BraTS-GLI-02549-102-seg.nii.gz,45,77,73,31,76,38,110,53,102,45,72,49
02735-101,../../DataSet/BraTS2024-BraTS-GLI-TrainingData/BraTS-GLI-02735-101/BraTS-GLI-02735-101-t1c.nii.gz,../../DataSet/BraTS2024-BraTS-GLI-TrainingData/BraTS-GLI-02735-101/BraTS-GLI-02735-101-t2w.nii.gz,../../DataSet/BraTS2024-BraTS-GLI-TrainingData/BraTS-GLI-02735-101/BraTS-GLI-02735-101-t2f.nii.gz,../../DataSet/BraTS2024-BraTS-GLI-TrainingData/BraTS-GLI-02735-101/BraTS-GLI-02735-101-t1n.nii.gz,../../DataSet/BraTS2024-BraTS-GLI-TrainingData/BraTS-GLI-02735-101/BraTS-GLI-02735-101-seg.nii.gz,63,156,94,43,82,122,190,65,127,39,68,62
02092-101,../../DataSet/BraTS2024-BraTS-GLI-TrainingData/BraTS-GLI-02092-101/BraTS-GLI-02092-101-t1c.nii.gz,../../DataSet/BraTS2024-BraTS-GLI-TrainingData/BraTS-GLI-02092-101/BraTS-GLI-02092-101-t2w.nii.gz,../../DataSet/BraTS2024-BraTS-GLI-TrainingData/BraTS-GLI-02092-101/BraTS-GLI-02092-101-t2f.nii.gz,../../DataSet/BraTS2024-BraTS-GLI-TrainingData/BraTS-GLI-02092-101/BraTS-GLI-02092-101-t1n.nii.gz,../../DataSet/BraTS2024-BraTS-GLI-TrainingData/BraTS-GLI-02092-101/BraTS-GLI-02092-101-seg.nii.gz,99,162,92,58,129,115,195,60,128,71,80,68
02128-102,../../DataSet/BraTS2024-BraTS-GLI-TrainingData/BraTS-GLI-02128-102/BraTS-GLI-02128-102-t1c.nii.gz,../../DataSet/BraTS2024-BraTS-GLI-TrainingData/BraTS-GLI-02128-102/BraTS-GLI-02128-102-t2w.nii.gz,../../DataSet/BraTS2024-BraTS-GLI-TrainingData/BraTS-GLI-02128-102/BraTS-GLI-02128-102-t2f.nii.gz,../../DataSet/BraTS2024-BraTS-GLI-TrainingData/BraTS-GLI-02128-102/BraTS-GLI-02128-102-t1n.nii.gz,../../DataSet/BraTS2024-BraTS-GLI-TrainingData/BraTS-GLI-02128-102/BraTS-GLI-02128-102-seg.nii.gz,76,81,122,45,131,46,121,87,157,86,75,70
02666-100,../../DataSet/BraTS2024-BraTS-GLI-TrainingData/BraTS-GLI-02666-100/BraTS-GLI-02666-100-t1c.nii.gz,../../DataSet/BraTS2024-BraTS-GLI-TrainingData/BraTS-GLI-02666-100/BraTS-GLI-02666-100-t2w.nii.gz,../../DataSet/BraTS2024-BraTS-GLI-TrainingData/BraTS-GLI-02666-100/BraTS-GLI-02666-100-t2f.nii.gz,../../DataSet/BraTS2024-BraTS-GLI-TrainingData/BraTS-GLI-02666-100/BraTS-GLI-02666-100-t1n.nii.gz,../../DataSet/BraTS2024-BraTS-GLI-TrainingData/BraTS-GLI-02666-100/BraTS-GLI-02666-100-seg.nii.gz,111,170,90,70,145,138,199,50,133,75,61,83
02132-104,../../DataSet/BraTS2024-BraTS-GLI-TrainingData/BraTS-GLI-02132-104/BraTS-GLI-02132-104-t1c.nii.gz,../../DataSet/BraTS2024-BraTS-GLI-TrainingData/BraTS-GLI-02132-104/BraTS-GLI-02132-104-t2w.nii.gz,../../DataSet/BraTS2024-BraTS-GLI-TrainingData/BraTS-GLI-02132-104/BraTS-GLI-02132-104-t2f.nii.gz,../../DataSet/BraTS2024-BraTS-GLI-TrainingData/BraTS-GLI-02132-104/BraTS-GLI-02132-104-t1n.nii.gz,../../DataSet/BraTS2024-BraTS-GLI-TrainingData/BraTS-GLI-02132-104/BraTS-GLI-02132-104-seg.nii.gz,106,129,116,74,137,80,176,81,151,63,96,70
02598-102,../../DataSet/BraTS2024-BraTS-GLI-TrainingData/BraTS-GLI-02598-102/BraTS-GLI-02598-102-t1c.nii.gz,../../DataSet/BraTS2024-BraTS-GLI-TrainingData/BraTS-GLI-02598-102/BraTS-GLI-02598-102-t2w.nii.gz,../../DataSet/BraTS2024-BraTS-GLI-TrainingData/BraTS-GLI-02598-102/BraTS-GLI-02598-102-t2f.nii.gz,../../DataSet/BraTS2024-BraTS-GLI-TrainingData/BraTS-GLI-02598-102/BraTS-GLI-02598-102-t1n.nii.gz,../../DataSet/BraTS2024-BraTS-GLI-TrainingData/BraTS-GLI-02598-102/BraTS-GLI-02598-102-seg.nii.gz,82,108,128,62,97,73,164,84,156,35,91,72
02207-100,../../DataSet/BraTS2024-BraTS-GLI-TrainingData/BraTS-GLI-02207-100/BraTS-GLI-02207-100-t1c.nii.gz,../../DataSet/BraTS2024-BraTS-GLI-TrainingData/BraTS-GLI-02207-100/BraTS-GLI-02207-100-t2w.nii.gz,../../DataSet/BraTS2024-BraTS-GLI-TrainingData/BraTS-GLI-02207-100/BraTS-GLI-02207-100-t2f.nii.gz,../../DataSet/BraTS2024-BraTS-GLI-TrainingData/BraTS-GLI-02207-100/BraTS-GLI-02207-100-t1n.nii.gz,../../DataSet/BraTS2024-BraTS-GLI-TrainingData/BraTS-GLI-02207-100/BraTS-GLI-02207-100-seg.nii.gz,112,156,85,62,151,113,198,50,135,89,85,85
02798-101,../../DataSet/BraTS2024-BraTS-GLI-TrainingData/BraTS-GLI-02798-101/BraTS-GLI-02798-101-t1c.nii.gz,../../DataSet/BraTS2024-BraTS-GLI-TrainingData/BraTS-GLI-02798-101/BraTS-GLI-02798-101-t2w.nii.gz,../../DataSet/BraTS2024-BraTS-GLI-TrainingData/BraTS-GLI-02798-101/BraTS-GLI-02798-101-t2f.nii.gz,../../DataSet/BraTS2024-BraTS-GLI-TrainingData/BraTS-GLI-02798-101/BraTS-GLI-02798-101-t1n.nii.gz,../../DataSet/BraTS2024-BraTS-GLI-TrainingData/BraTS-GLI-02798-101/BraTS-GLI-02798-101-seg.nii.gz,133,79,110,115,147,67,90,105,120,32,23,15
02248-103,../../DataSet/BraTS2024-BraTS-GLI-TrainingData/BraTS-GLI-02248-103/BraTS-GLI-02248-103-t1c.nii.gz,../../DataSet/BraTS2024-BraTS-GLI-TrainingData/BraTS-GLI-02248-103/BraTS-GLI-02248-103-t2w.nii.gz,../../DataSet/BraTS2024-BraTS-GLI-TrainingData/BraTS-GLI-02248-103/BraTS-GLI-02248-103-t2f.nii.gz,../../DataSet/BraTS2024-BraTS-GLI-TrainingData/BraTS-GLI-02248-103/BraTS-GLI-02248-103-t1n.nii.gz,../../DataSet/BraTS2024-BraTS-GLI-TrainingData/BraTS-GLI-02248-103/BraTS-GLI-02248-103-seg.nii.gz,107,77,105,64,129,45,112,74,142,65,67,68
02827-100,../../DataSet/BraTS2024-BraTS-GLI-TrainingData/BraTS-GLI-02827-100/BraTS-GLI-02827-100-t1c.nii.gz,../../DataSet/BraTS2024-BraTS-GLI-TrainingData/BraTS-GLI-02827-100/BraTS-GLI-02827-100-t2w.nii.gz,../../DataSet/BraTS2024-BraTS-GLI-TrainingData/BraTS-GLI-02827-100/BraTS-GLI-02827-100-t2f.nii.gz,../../DataSet/BraTS2024-BraTS-GLI-TrainingData/BraTS-GLI-02827-100/BraTS-GLI-02827-100-t1n.nii.gz,../../DataSet/BraTS2024-BraTS-GLI-TrainingData/BraTS-GLI-02827-100/BraTS-GLI-02827-100-seg.nii.gz,130,118,66,105,155,81,148,44,108,50,67,64
03051-101,../../DataSet/BraTS2024-BraTS-GLI-TrainingData/BraTS-GLI-03051-101/BraTS-GLI-03051-101-t1c.nii.gz,../../DataSet/BraTS2024-BraTS-GLI-TrainingData/BraTS-GLI-03051-101/BraTS-GLI-03051-101-t2w.nii.gz,../../DataSet/BraTS2024-BraTS-GLI-TrainingData/BraTS-GLI-03051-101/BraTS-GLI-03051-101-t2f.nii.gz,../../DataSet/BraTS2024-BraTS-GLI-TrainingData/BraTS-GLI-03051-101/BraTS-GLI-03051-101-t1n.nii.gz,../../DataSet/BraTS2024-BraTS-GLI-TrainingData/BraTS-GLI-03051-101/BraTS-GLI-03051-101-seg.nii.gz,81,85,110,56,128,48,122,49,141,72,74,92
02524-105,../../DataSet/BraTS2024-BraTS-GLI-TrainingData/BraTS-GLI-02524-105/BraTS-GLI-02524-105-t1c.nii.gz,../../DataSet/BraTS2024-BraTS-GLI-TrainingData/BraTS-GLI-02524-105/BraTS-GLI-02524-105-t2w.nii.gz,../../DataSet/BraTS2024-BraTS-GLI-TrainingData/BraTS-GLI-02524-105/BraTS-GLI-02524-105-t2f.nii.gz,../../DataSet/BraTS2024-BraTS-GLI-TrainingData/BraTS-GLI-02524-105/BraTS-GLI-02524-105-t1n.nii.gz,../../DataSet/BraTS2024-BraTS-GLI-TrainingData/BraTS-GLI-02524-105/BraTS-GLI-02524-105-seg.nii.gz,110,108,110,69,139,67,150,73,147,70,83,74
00548-101,../../DataSet/BraTS2024-BraTS-GLI-TrainingData/BraTS-GLI-00548-101/BraTS-GLI-00548-101-t1c.nii.gz,../../DataSet/BraTS2024-BraTS-GLI-TrainingData/BraTS-GLI-00548-101/BraTS-GLI-00548-101-t2w.nii.gz,../../DataSet/BraTS2024-BraTS-GLI-TrainingData/BraTS-GLI-00548-101/BraTS-GLI-00548-101-t2f.nii.gz,../../DataSet/BraTS2024-BraTS-GLI-TrainingData/BraTS-GLI-00548-101/BraTS-GLI-00548-101-t1n.nii.gz,../../DataSet/BraTS2024-BraTS-GLI-TrainingData/BraTS-GLI-00548-101/BraTS-GLI-00548-101-seg.nii.gz,53,123,63,32,74,80,149,49,85,42,69,36
02061-102,../../DataSet/BraTS2024-BraTS-GLI-TrainingData/BraTS-GLI-02061-102/BraTS-GLI-02061-102-t1c.nii.gz,../../DataSet/BraTS2024-BraTS-GLI-TrainingData/BraTS-GLI-02061-102/BraTS-GLI-02061-102-t2w.nii.gz,../../DataSet/BraTS2024-BraTS-GLI-TrainingData/BraTS-GLI-02061-102/BraTS-GLI-02061-102-t2f.nii.gz,../../DataSet/BraTS2024-BraTS-GLI-TrainingData/BraTS-GLI-02061-102/BraTS-GLI-02061-102-t1n.nii.gz,../../DataSet/BraTS2024-BraTS-GLI-TrainingData/BraTS-GLI-02061-102/BraTS-GLI-02061-102-seg.nii.gz,95,88,127,61,140,56,130,89,155,79,74,66
02132-103,../../DataSet/BraTS2024-BraTS-GLI-TrainingData/BraTS-GLI-02132-103/BraTS-GLI-02132-103-t1c.nii.gz,../../DataSet/BraTS2024-BraTS-GLI-TrainingData/BraTS-GLI-02132-103/BraTS-GLI-02132-103-t2w.nii.gz,../../DataSet/BraTS2024-BraTS-GLI-TrainingData/BraTS-GLI-02132-103/BraTS-GLI-02132-103-t2f.nii.gz,../../DataSet/BraTS2024-BraTS-GLI-TrainingData/BraTS-GLI-02132-103/BraTS-GLI-02132-103-t1n.nii.gz,../../DataSet/BraTS2024-BraTS-GLI-TrainingData/BraTS-GLI-02132-103/BraTS-GLI-02132-103-seg.nii.gz,104,130,118,70,134,92,168,89,149,64,76,60
02216-100,../../DataSet/BraTS2024-BraTS-GLI-TrainingData/BraTS-GLI-02216-100/BraTS-GLI-02216-100-t1c.nii.gz,../../DataSet/BraTS2024-BraTS-GLI-TrainingData/BraTS-GLI-02216-100/BraTS-GLI-02216-100-t2w.nii.gz,../../DataSet/BraTS2024-BraTS-GLI-TrainingData/BraTS-GLI-02216-100/BraTS-GLI-02216-100-t2f.nii.gz,../../DataSet/BraTS2024-BraTS-GLI-TrainingData/BraTS-GLI-02216-100/BraTS-GLI-02216-100-t1n.nii.gz,../../DataSet/BraTS2024-BraTS-GLI-TrainingData/BraTS-GLI-02216-100/BraTS-GLI-02216-100-seg.nii.gz,71,152,110,50,89,126,182,84,142,39,56,58
02890-101,../../DataSet/BraTS2024-BraTS-GLI-TrainingData/BraTS-GLI-02890-101/BraTS-GLI-02890-101-t1c.nii.gz,../../DataSet/BraTS2024-BraTS-GLI-TrainingData/BraTS-GLI-02890-101/BraTS-GLI-02890-101-t2w.nii.gz,../../DataSet/BraTS2024-BraTS-GLI-TrainingData/BraTS-GLI-02890-101/BraTS-GLI-02890-101-t2f.nii.gz,../../DataSet/BraTS2024-BraTS-GLI-TrainingData/BraTS-GLI-02890-101/BraTS-GLI-02890-101-t1n.nii.gz,../../DataSet/BraTS2024-BraTS-GLI-TrainingData/BraTS-GLI-02890-101/BraTS-GLI-02890-101-seg.nii.gz,117,134,93,70,149,89,178,49,136,79,89,87
02912-100,../../DataSet/BraTS2024-BraTS-GLI-TrainingData/BraTS-GLI-02912-100/BraTS-GLI-02912-100-t1c.nii.gz,../../DataSet/BraTS2024-BraTS-GLI-TrainingData/BraTS-GLI-02912-100/BraTS-GLI-02912-100-t2w.nii.gz,../../DataSet/BraTS2024-BraTS-GLI-TrainingData/BraTS-GLI-02912-100/BraTS-GLI-02912-100-t2f.nii.gz,../../DataSet/BraTS2024-BraTS-GLI-TrainingData/BraTS-GLI-02912-100/BraTS-GLI-02912-100-t1n.nii.gz,../../DataSet/BraTS2024-BraTS-GLI-TrainingData/BraTS-GLI-02912-100/BraTS-GLI-02912-100-seg.nii.gz,92,103,79,47,133,85,132,64,102,86,47,38
02083-101,../../DataSet/BraTS2024-BraTS-GLI-TrainingData/BraTS-GLI-02083-101/BraTS-GLI-02083-101-t1c.nii.gz,../../DataSet/BraTS2024-BraTS-GLI-TrainingData/BraTS-GLI-02083-101/BraTS-GLI-02083-101-t2w.nii.gz,../../DataSet/BraTS2024-BraTS-GLI-TrainingData/BraTS-GLI-02083-101/BraTS-GLI-02083-101-t2f.nii.gz,../../DataSet/BraTS2024-BraTS-GLI-TrainingData/BraTS-GLI-02083-101/BraTS-GLI-02083-101-t1n.nii.gz,../../DataSet/BraTS2024-BraTS-GLI-TrainingData/BraTS-GLI-02083-101/BraTS-GLI-02083-101-seg.nii.gz,76,80,132,50,118,57,119,105,157,68,62,52
02101-100,../../DataSet/BraTS2024-BraTS-GLI-TrainingData/BraTS-GLI-02101-100/BraTS-GLI-02101-100-t1c.nii.gz,../../DataSet/BraTS2024-BraTS-GLI-TrainingData/BraTS-GLI-02101-100/BraTS-GLI-02101-100-t2w.nii.gz,../../DataSet/BraTS2024-BraTS-GLI-TrainingData/BraTS-GLI-02101-100/BraTS-GLI-02101-100-t2f.nii.gz,../../DataSet/BraTS2024-BraTS-GLI-TrainingData/BraTS-GLI-02101-100/BraTS-GLI-02101-100-t1n.nii.gz,../../DataSet/BraTS2024-BraTS-GLI-TrainingData/BraTS-GLI-02101-100/BraTS-GLI-02101-100-seg.nii.gz,52,115,68,31,82,83,157,46,100,51,74,54
02836-100,../../DataSet/BraTS2024-BraTS-GLI-TrainingData/BraTS-GLI-02836-100/BraTS-GLI-02836-100-t1c.nii.gz,../../DataSet/BraTS2024-BraTS-GLI-TrainingData/BraTS-GLI-02836-100/BraTS-GLI-02836-100-t2w.nii.gz,../../DataSet/BraTS2024-BraTS-GLI-TrainingData/BraTS-GLI-02836-100/BraTS-GLI-02836-100-t2f.nii.gz,../../DataSet/BraTS2024-BraTS-GLI-TrainingData/BraTS-GLI-02836-100/BraTS-GLI-02836-100-t1n.nii.gz,../../DataSet/BraTS2024-BraTS-GLI-TrainingData/BraTS-GLI-02836-100/BraTS-GLI-02836-100-seg.nii.gz,56,125,84,30,91,84,157,52,120,61,73,68
02782-100,../../DataSet/BraTS2024-BraTS-GLI-TrainingData/BraTS-GLI-02782-100/BraTS-GLI-02782-100-t1c.nii.gz,../../DataSet/BraTS2024-BraTS-GLI-TrainingData/BraTS-GLI-02782-100/BraTS-GLI-02782-100-t2w.nii.gz,../../DataSet/BraTS2024-BraTS-GLI-TrainingData/BraTS-GLI-02782-100/BraTS-GLI-02782-100-t2f.nii.gz,../../DataSet/BraTS2024-BraTS-GLI-TrainingData/BraTS-GLI-02782-100/BraTS-GLI-02782-100-t1n.nii.gz,../../DataSet/BraTS2024-BraTS-GLI-TrainingData/BraTS-GLI-02782-100/BraTS-GLI-02782-100-seg.nii.gz,95,144,115,56,132,90,183,84,145,76,93,61
00006-100,../../DataSet/BraTS2024-BraTS-GLI-TrainingData/BraTS-GLI-00006-100/BraTS-GLI-00006-100-t1c.nii.gz,../../DataSet/BraTS2024-BraTS-GLI-TrainingData/BraTS-GLI-00006-100/BraTS-GLI-00006-100-t2w.nii.gz,../../DataSet/BraTS2024-BraTS-GLI-TrainingData/BraTS-GLI-00006-100/BraTS-GLI-00006-100-t2f.nii.gz,../../DataSet/BraTS2024-BraTS-GLI-TrainingData/BraTS-GLI-00006-100/BraTS-GLI-00006-100-t1n.nii.gz,../../DataSet/BraTS2024-BraTS-GLI-TrainingData/BraTS-GLI-00006-100/BraTS-GLI-00006-100-seg.nii.gz,108,168,89,69,134,138,193,69,118,65,55,49
02965-101,../../DataSet/BraTS2024-BraTS-GLI-TrainingData/BraTS-GLI-02965-101/BraTS-GLI-02965-101-t1c.nii.gz,../../DataSet/BraTS2024-BraTS-GLI-TrainingData/BraTS-GLI-02965-101/BraTS-GLI-02965-101-t2w.nii.gz,../../DataSet/BraTS2024-BraTS-GLI-TrainingData/BraTS-GLI-02965-101/BraTS-GLI-02965-101-t2f.nii.gz,../../DataSet/BraTS2024-BraTS-GLI-TrainingData/BraTS-GLI-02965-101/BraTS-GLI-02965-101-t1n.nii.gz,../../DataSet/BraTS2024-BraTS-GLI-TrainingData/BraTS-GLI-02965-101/BraTS-GLI-02965-101-seg.nii.gz,40,108,74,24,68,66,148,53,100,44,82,47
02789-101,../../DataSet/BraTS2024-BraTS-GLI-TrainingData/BraTS-GLI-02789-101/BraTS-GLI-02789-101-t1c.nii.gz,../../DataSet/BraTS2024-BraTS-GLI-TrainingData/BraTS-GLI-02789-101/BraTS-GLI-02789-101-t2w.nii.gz,../../DataSet/BraTS2024-BraTS-GLI-TrainingData/BraTS-GLI-02789-101/BraTS-GLI-02789-101-t2f.nii.gz,../../DataSet/BraTS2024-BraTS-GLI-TrainingData/BraTS-GLI-02789-101/BraTS-GLI-02789-101-t1n.nii.gz,../../DataSet/BraTS2024-BraTS-GLI-TrainingData/BraTS-GLI-02789-101/BraTS-GLI-02789-101-seg.nii.gz,58,124,102,27,110,94,156,63,136,83,62,73
02524-102,../../DataSet/BraTS2024-BraTS-GLI-TrainingData/BraTS-GLI-02524-102/BraTS-GLI-02524-102-t1c.nii.gz,../../DataSet/BraTS2024-BraTS-GLI-TrainingData/BraTS-GLI-02524-102/BraTS-GLI-02524-102-t2w.nii.gz,../../DataSet/BraTS2024-BraTS-GLI-TrainingData/BraTS-GLI-02524-102/BraTS-GLI-02524-102-t2f.nii.gz,../../DataSet/BraTS2024-BraTS-GLI-TrainingData/BraTS-GLI-02524-102/BraTS-GLI-02524-102-t1n.nii.gz,../../DataSet/BraTS2024-BraTS-GLI-TrainingData/BraTS-GLI-02524-102/BraTS-GLI-02524-102-seg.nii.gz,110,109,124,91,133,88,134,102,144,42,46,42
02758-101,../../DataSet/BraTS2024-BraTS-GLI-TrainingData/BraTS-GLI-02758-101/BraTS-GLI-02758-101-t1c.nii.gz,../../DataSet/BraTS2024-BraTS-GLI-TrainingData/BraTS-GLI-02758-101/BraTS-GLI-02758-101-t2w.nii.gz,../../DataSet/BraTS2024-BraTS-GLI-TrainingData/BraTS-GLI-02758-101/BraTS-GLI-02758-101-t2f.nii.gz,../../DataSet/BraTS2024-BraTS-GLI-TrainingData/BraTS-GLI-02758-101/BraTS-GLI-02758-101-t1n.nii.gz,../../DataSet/BraTS2024-BraTS-GLI-TrainingData/BraTS-GLI-02758-101/BraTS-GLI-02758-101-seg.nii.gz,104,170,85,86,133,142,192,65,116,47,50,51
00533-101,../../DataSet/BraTS2024-BraTS-GLI-TrainingData/BraTS-GLI-00533-101/BraTS-GLI-00533-101-t1c.nii.gz,../../DataSet/BraTS2024-BraTS-GLI-TrainingData/BraTS-GLI-00533-101/BraTS-GLI-00533-101-t2w.nii.gz,../../DataSet/BraTS2024-BraTS-GLI-TrainingData/BraTS-GLI-00533-101/BraTS-GLI-00533-101-t2f.nii.gz,../../DataSet/BraTS2024-BraTS-GLI-TrainingData/BraTS-GLI-00533-101/BraTS-GLI-00533-101-t1n.nii.gz,../../DataSet/BraTS2024-BraTS-GLI-TrainingData/BraTS-GLI-00533-101/BraTS-GLI-00533-101-seg.nii.gz,118,67,82,57,150,25,118,55,124,93,93,69
02831-100,../../DataSet/BraTS2024-BraTS-GLI-TrainingData/BraTS-GLI-02831-100/BraTS-GLI-02831-100-t1c.nii.gz,../../DataSet/BraTS2024-BraTS-GLI-TrainingData/BraTS-GLI-02831-100/BraTS-GLI-02831-100-t2w.nii.gz,../../DataSet/BraTS2024-BraTS-GLI-TrainingData/BraTS-GLI-02831-100/BraTS-GLI-02831-100-t2f.nii.gz,../../DataSet/BraTS2024-BraTS-GLI-TrainingData/BraTS-GLI-02831-100/BraTS-GLI-02831-100-t1n.nii.gz,../../DataSet/BraTS2024-BraTS-GLI-TrainingData/BraTS-GLI-02831-100/BraTS-GLI-02831-100-seg.nii.gz,59,52,95,37,81,33,77,68,120,44,44,52
02198-103,../../DataSet/BraTS2024-BraTS-GLI-TrainingData/BraTS-GLI-02198-103/BraTS-GLI-02198-103-t1c.nii.gz,../../DataSet/BraTS2024-BraTS-GLI-TrainingData/BraTS-GLI-02198-103/BraTS-GLI-02198-103-t2w.nii.gz,../../DataSet/BraTS2024-BraTS-GLI-TrainingData/BraTS-GLI-02198-103/BraTS-GLI-02198-103-t2f.nii.gz,../../DataSet/BraTS2024-BraTS-GLI-TrainingData/BraTS-GLI-02198-103/BraTS-GLI-02198-103-t1n.nii.gz,../../DataSet/BraTS2024-BraTS-GLI-TrainingData/BraTS-GLI-02198-103/BraTS-GLI-02198-103-seg.nii.gz,64,66,98,34,127,29,120,67,131,93,91,64
02171-101,../../DataSet/BraTS2024-BraTS-GLI-TrainingData/BraTS-GLI-02171-101/BraTS-GLI-02171-101-t1c.nii.gz,../../DataSet/BraTS2024-BraTS-GLI-TrainingData/BraTS-GLI-02171-101/BraTS-GLI-02171-101-t2w.nii.gz,../../DataSet/BraTS2024-BraTS-GLI-TrainingData/BraTS-GLI-02171-101/BraTS-GLI-02171-101-t2f.nii.gz,../../DataSet/BraTS2024-BraTS-GLI-TrainingData/BraTS-GLI-02171-101/BraTS-GLI-02171-101-t1n.nii.gz,../../DataSet/BraTS2024-BraTS-GLI-TrainingData/BraTS-GLI-02171-101/BraTS-GLI-02171-101-seg.nii.gz,62,164,91,30,95,113,200,57,123,65,87,66
02149-103,../../DataSet/BraTS2024-BraTS-GLI-TrainingData/BraTS-GLI-02149-103/BraTS-GLI-02149-103-t1c.nii.gz,../../DataSet/BraTS2024-BraTS-GLI-TrainingData/BraTS-GLI-02149-103/BraTS-GLI-02149-103-t2w.nii.gz,../../DataSet/BraTS2024-BraTS-GLI-TrainingData/BraTS-GLI-02149-103/BraTS-GLI-02149-103-t2f.nii.gz,../../DataSet/BraTS2024-BraTS-GLI-TrainingData/BraTS-GLI-02149-103/BraTS-GLI-02149-103-t1n.nii.gz,../../DataSet/BraTS2024-BraTS-GLI-TrainingData/BraTS-GLI-02149-103/BraTS-GLI-02149-103-seg.nii.gz,103,83,121,66,126,47,119,90,150,60,72,60
02335-100,../../DataSet/BraTS2024-BraTS-GLI-TrainingData/BraTS-GLI-02335-100/BraTS-GLI-02335-100-t1c.nii.gz,../../DataSet/BraTS2024-BraTS-GLI-TrainingData/BraTS-GLI-02335-100/BraTS-GLI-02335-100-t2w.nii.gz,../../DataSet/BraTS2024-BraTS-GLI-TrainingData/BraTS-GLI-02335-100/BraTS-GLI-02335-100-t2f.nii.gz,../../DataSet/BraTS2024-BraTS-GLI-TrainingData/BraTS-GLI-02335-100/BraTS-GLI-02335-100-t1n.nii.gz,../../DataSet/BraTS2024-BraTS-GLI-TrainingData/BraTS-GLI-02335-100/BraTS-GLI-02335-100-seg.nii.gz,110,95,122,92,138,63,121,100,147,46,58,47
02193-102,../../DataSet/BraTS2024-BraTS-GLI-TrainingData/BraTS-GLI-02193-102/BraTS-GLI-02193-102-t1c.nii.gz,../../DataSet/BraTS2024-BraTS-GLI-TrainingData/BraTS-GLI-02193-102/BraTS-GLI-02193-102-t2w.nii.gz,../../DataSet/BraTS2024-BraTS-GLI-TrainingData/BraTS-GLI-02193-102/BraTS-GLI-02193-102-t2f.nii.gz,../../DataSet/BraTS2024-BraTS-GLI-TrainingData/BraTS-GLI-02193-102/BraTS-GLI-02193-102-t1n.nii.gz,../../DataSet/BraTS2024-BraTS-GLI-TrainingData/BraTS-GLI-02193-102/BraTS-GLI-02193-102-seg.nii.gz,124,83,116,95,154,50,128,80,148,59,78,68
02969-100,../../DataSet/BraTS2024-BraTS-GLI-TrainingData/BraTS-GLI-02969-100/BraTS-GLI-02969-100-t1c.nii.gz,../../DataSet/BraTS2024-BraTS-GLI-TrainingData/BraTS-GLI-02969-100/BraTS-GLI-02969-100-t2w.nii.gz,../../DataSet/BraTS2024-BraTS-GLI-TrainingData/BraTS-GLI-02969-100/BraTS-GLI-02969-100-t2f.nii.gz,../../DataSet/BraTS2024-BraTS-GLI-TrainingData/BraTS-GLI-02969-100/BraTS-GLI-02969-100-t1n.nii.gz,../../DataSet/BraTS2024-BraTS-GLI-TrainingData/BraTS-GLI-02969-100/BraTS-GLI-02969-100-seg.nii.gz,63,88,128,40,100,67,118,106,150,60,51,44
02066-102,../../DataSet/BraTS2024-BraTS-GLI-TrainingData/BraTS-GLI-02066-102/BraTS-GLI-02066-102-t1c.nii.gz,../../DataSet/BraTS2024-BraTS-GLI-TrainingData/BraTS-GLI-02066-102/BraTS-GLI-02066-102-t2w.nii.gz,../../DataSet/BraTS2024-BraTS-GLI-TrainingData/BraTS-GLI-02066-102/BraTS-GLI-02066-102-t2f.nii.gz,../../DataSet/BraTS2024-BraTS-GLI-TrainingData/BraTS-GLI-02066-102/BraTS-GLI-02066-102-t1n.nii.gz,../../DataSet/BraTS2024-BraTS-GLI-TrainingData/BraTS-GLI-02066-102/BraTS-GLI-02066-102-seg.nii.gz,110,71,126,93,131,44,99,90,154,38,55,64
02211-100,../../DataSet/BraTS2024-BraTS-GLI-TrainingData/BraTS-GLI-02211-100/BraTS-GLI-02211-100-t1c.nii.gz,../../DataSet/BraTS2024-BraTS-GLI-TrainingData/BraTS-GLI-02211-100/BraTS-GLI-02211-100-t2w.nii.gz,../../DataSet/BraTS2024-BraTS-GLI-TrainingData/BraTS-GLI-02211-100/BraTS-GLI-02211-100-t2f.nii.gz,../../DataSet/BraTS2024-BraTS-GLI-TrainingData/BraTS-GLI-02211-100/BraTS-GLI-02211-100-t1n.nii.gz,../../DataSet/BraTS2024-BraTS-GLI-TrainingData/BraTS-GLI-02211-100/BraTS-GLI-02211-100-seg.nii.gz,65,138,124,41,85,117,163,99,148,44,46,49
02897-101,../../DataSet/BraTS2024-BraTS-GLI-TrainingData/BraTS-GLI-02897-101/BraTS-GLI-02897-101-t1c.nii.gz,../../DataSet/BraTS2024-BraTS-GLI-TrainingData/BraTS-GLI-02897-101/BraTS-GLI-02897-101-t2w.nii.gz,../../DataSet/BraTS2024-BraTS-GLI-TrainingData/BraTS-GLI-02897-101/BraTS-GLI-02897-101-t2f.nii.gz,../../DataSet/BraTS2024-BraTS-GLI-TrainingData/BraTS-GLI-02897-101/BraTS-GLI-02897-101-t1n.nii.gz,../../DataSet/BraTS2024-BraTS-GLI-TrainingData/BraTS-GLI-02897-101/BraTS-GLI-02897-101-seg.nii.gz,121,126,83,94,155,86,154,57,120,61,68,63
02106-100,../../DataSet/BraTS2024-BraTS-GLI-TrainingData/BraTS-GLI-02106-100/BraTS-GLI-02106-100-t1c.nii.gz,../../DataSet/BraTS2024-BraTS-GLI-TrainingData/BraTS-GLI-02106-100/BraTS-GLI-02106-100-t2w.nii.gz,../../DataSet/BraTS2024-BraTS-GLI-TrainingData/BraTS-GLI-02106-100/BraTS-GLI-02106-100-t2f.nii.gz,../../DataSet/BraTS2024-BraTS-GLI-TrainingData/BraTS-GLI-02106-100/BraTS-GLI-02106-100-t1n.nii.gz,../../DataSet/BraTS2024-BraTS-GLI-TrainingData/BraTS-GLI-02106-100/BraTS-GLI-02106-100-seg.nii.gz,65,109,103,40,86,70,148,57,137,46,78,80
02084-101,../../DataSet/BraTS2024-BraTS-GLI-TrainingData/BraTS-GLI-02084-101/BraTS-GLI-02084-101-t1c.nii.gz,../../DataSet/BraTS2024-BraTS-GLI-TrainingData/BraTS-GLI-02084-101/BraTS-GLI-02084-101-t2w.nii.gz,../../DataSet/BraTS2024-BraTS-GLI-TrainingData/BraTS-GLI-02084-101/BraTS-GLI-02084-101-t2f.nii.gz,../../DataSet/BraTS2024-BraTS-GLI-TrainingData/BraTS-GLI-02084-101/BraTS-GLI-02084-101-t1n.nii.gz,../../DataSet/BraTS2024-BraTS-GLI-TrainingData/BraTS-GLI-02084-101/BraTS-GLI-02084-101-seg.nii.gz,130,82,81,107,156,46,126,49,111,49,80,62
02196-103,../../DataSet/BraTS2024-BraTS-GLI-TrainingData/BraTS-GLI-02196-103/BraTS-GLI-02196-103-t1c.nii.gz,../../DataSet/BraTS2024-BraTS-GLI-TrainingData/BraTS-GLI-02196-103/BraTS-GLI-02196-103-t2w.nii.gz,../../DataSet/BraTS2024-BraTS-GLI-TrainingData/BraTS-GLI-02196-103/BraTS-GLI-02196-103-t2f.nii.gz,../../DataSet/BraTS2024-BraTS-GLI-TrainingData/BraTS-GLI-02196-103/BraTS-GLI-02196-103-t1n.nii.gz,../../DataSet/BraTS2024-BraTS-GLI-TrainingData/BraTS-GLI-02196-103/BraTS-GLI-02196-103-seg.nii.gz,87,155,104,41,131,114,194,63,143,90,80,80
03049-101,../../DataSet/BraTS2024-BraTS-GLI-TrainingData/BraTS-GLI-03049-101/BraTS-GLI-03049-101-t1c.nii.gz,../../DataSet/BraTS2024-BraTS-GLI-TrainingData/BraTS-GLI-03049-101/BraTS-GLI-03049-101-t2w.nii.gz,../../DataSet/BraTS2024-BraTS-GLI-TrainingData/BraTS-GLI-03049-101/BraTS-GLI-03049-101-t2f.nii.gz,../../DataSet/BraTS2024-BraTS-GLI-TrainingData/BraTS-GLI-03049-101/BraTS-GLI-03049-101-t1n.nii.gz,../../DataSet/BraTS2024-BraTS-GLI-TrainingData/BraTS-GLI-03049-101/BraTS-GLI-03049-101-seg.nii.gz,123,109,71,103,146,78,134,52,92,43,56,40
02602-100,../../DataSet/BraTS2024-BraTS-GLI-TrainingData/BraTS-GLI-02602-100/BraTS-GLI-02602-100-t1c.nii.gz,../../DataSet/BraTS2024-BraTS-GLI-TrainingData/BraTS-GLI-02602-100/BraTS-GLI-02602-100-t2w.nii.gz,../../DataSet/BraTS2024-BraTS-GLI-TrainingData/BraTS-GLI-02602-100/BraTS-GLI-02602-100-t2f.nii.gz,../../DataSet/BraTS2024-BraTS-GLI-TrainingData/BraTS-GLI-02602-100/BraTS-GLI-02602-100-t1n.nii.gz,../../DataSet/BraTS2024-BraTS-GLI-TrainingData/BraTS-GLI-02602-100/BraTS-GLI-02602-100-seg.nii.gz,114,123,65,88,138,93,151,34,96,50,58,62
02780-101,../../DataSet/BraTS2024-BraTS-GLI-TrainingData/BraTS-GLI-02780-101/BraTS-GLI-02780-101-t1c.nii.gz,../../DataSet/BraTS2024-BraTS-GLI-TrainingData/BraTS-GLI-02780-101/BraTS-GLI-02780-101-t2w.nii.gz,../../DataSet/BraTS2024-BraTS-GLI-TrainingData/BraTS-GLI-02780-101/BraTS-GLI-02780-101-t2f.nii.gz,../../DataSet/BraTS2024-BraTS-GLI-TrainingData/BraTS-GLI-02780-101/BraTS-GLI-02780-101-t1n.nii.gz,../../DataSet/BraTS2024-BraTS-GLI-TrainingData/BraTS-GLI-02780-101/BraTS-GLI-02780-101-seg.nii.gz,50,116,62,32,73,91,141,47,81,41,50,34
02834-101,../../DataSet/BraTS2024-BraTS-GLI-TrainingData/BraTS-GLI-02834-101/BraTS-GLI-02834-101-t1c.nii.gz,../../DataSet/BraTS2024-BraTS-GLI-TrainingData/BraTS-GLI-02834-101/BraTS-GLI-02834-101-t2w.nii.gz,../../DataSet/BraTS2024-BraTS-GLI-TrainingData/BraTS-GLI-02834-101/BraTS-GLI-02834-101-t2f.nii.gz,../../DataSet/BraTS2024-BraTS-GLI-TrainingData/BraTS-GLI-02834-101/BraTS-GLI-02834-101-t1n.nii.gz,../../DataSet/BraTS2024-BraTS-GLI-TrainingData/BraTS-GLI-02834-101/BraTS-GLI-02834-101-seg.nii.gz,82,114,107,48,131,72,158,82,138,83,86,56
02515-100,../../DataSet/BraTS2024-BraTS-GLI-TrainingData/BraTS-GLI-02515-100/BraTS-GLI-02515-100-t1c.nii.gz,../../DataSet/BraTS2024-BraTS-GLI-TrainingData/BraTS-GLI-02515-100/BraTS-GLI-02515-100-t2w.nii.gz,../../DataSet/BraTS2024-BraTS-GLI-TrainingData/BraTS-GLI-02515-100/BraTS-GLI-02515-100-t2f.nii.gz,../../DataSet/BraTS2024-BraTS-GLI-TrainingData/BraTS-GLI-02515-100/BraTS-GLI-02515-100-t1n.nii.gz,../../DataSet/BraTS2024-BraTS-GLI-TrainingData/BraTS-GLI-02515-100/BraTS-GLI-02515-100-seg.nii.gz,110,58,99,91,141,24,104,65,142,50,80,77
02967-100,../../DataSet/BraTS2024-BraTS-GLI-TrainingData/BraTS-GLI-02967-100/BraTS-GLI-02967-100-t1c.nii.gz,../../DataSet/BraTS2024-BraTS-GLI-TrainingData/BraTS-GLI-02967-100/BraTS-GLI-02967-100-t2w.nii.gz,../../DataSet/BraTS2024-BraTS-GLI-TrainingData/BraTS-GLI-02967-100/BraTS-GLI-02967-100-t2f.nii.gz,../../DataSet/BraTS2024-BraTS-GLI-TrainingData/BraTS-GLI-02967-100/BraTS-GLI-02967-100-t1n.nii.gz,../../DataSet/BraTS2024-BraTS-GLI-TrainingData/BraTS-GLI-02967-100/BraTS-GLI-02967-100-seg.nii.gz,108,51,90,53,139,18,96,67,111,86,78,44
02174-100,../../DataSet/BraTS2024-BraTS-GLI-TrainingData/BraTS-GLI-02174-100/BraTS-GLI-02174-100-t1c.nii.gz,../../DataSet/BraTS2024-BraTS-GLI-TrainingData/BraTS-GLI-02174-100/BraTS-GLI-02174-100-t2w.nii.gz,../../DataSet/BraTS2024-BraTS-GLI-TrainingData/BraTS-GLI-02174-100/BraTS-GLI-02174-100-t2f.nii.gz,../../DataSet/BraTS2024-BraTS-GLI-TrainingData/BraTS-GLI-02174-100/BraTS-GLI-02174-100-t1n.nii.gz,../../DataSet/BraTS2024-BraTS-GLI-TrainingData/BraTS-GLI-02174-100/BraTS-GLI-02174-100-seg.nii.gz,110,124,122,60,140,81,160,91,153,80,79,62
02751-101,../../DataSet/BraTS2024-BraTS-GLI-TrainingData/BraTS-GLI-02751-101/BraTS-GLI-02751-101-t1c.nii.gz,../../DataSet/BraTS2024-BraTS-GLI-TrainingData/BraTS-GLI-02751-101/BraTS-GLI-02751-101-t2w.nii.gz,../../DataSet/BraTS2024-BraTS-GLI-TrainingData/BraTS-GLI-02751-101/BraTS-GLI-02751-101-t2f.nii.gz,../../DataSet/BraTS2024-BraTS-GLI-TrainingData/BraTS-GLI-02751-101/BraTS-GLI-02751-101-t1n.nii.gz,../../DataSet/BraTS2024-BraTS-GLI-TrainingData/BraTS-GLI-02751-101/BraTS-GLI-02751-101-seg.nii.gz,68,91,112,39,91,62,139,86,138,52,77,52
02843-100,../../DataSet/BraTS2024-BraTS-GLI-TrainingData/BraTS-GLI-02843-100/BraTS-GLI-02843-100-t1c.nii.gz,../../DataSet/BraTS2024-BraTS-GLI-TrainingData/BraTS-GLI-02843-100/BraTS-GLI-02843-100-t2w.nii.gz,../../DataSet/BraTS2024-BraTS-GLI-TrainingData/BraTS-GLI-02843-100/BraTS-GLI-02843-100-t2f.nii.gz,../../DataSet/BraTS2024-BraTS-GLI-TrainingData/BraTS-GLI-02843-100/BraTS-GLI-02843-100-t1n.nii.gz,../../DataSet/BraTS2024-BraTS-GLI-TrainingData/BraTS-GLI-02843-100/BraTS-GLI-02843-100-seg.nii.gz,108,82,122,97,131,58,105,103,143,34,47,40
02081-100,../../DataSet/BraTS2024-BraTS-GLI-TrainingData/BraTS-GLI-02081-100/BraTS-GLI-02081-100-t1c.nii.gz,../../DataSet/BraTS2024-BraTS-GLI-TrainingData/BraTS-GLI-02081-100/BraTS-GLI-02081-100-t2w.nii.gz,../../DataSet/BraTS2024-BraTS-GLI-TrainingData/BraTS-GLI-02081-100/BraTS-GLI-02081-100-t2f.nii.gz,../../DataSet/BraTS2024-BraTS-GLI-TrainingData/BraTS-GLI-02081-100/BraTS-GLI-02081-100-t1n.nii.gz,../../DataSet/BraTS2024-BraTS-GLI-TrainingData/BraTS-GLI-02081-100/BraTS-GLI-02081-100-seg.nii.gz,106,169,89,73,134,137,197,56,134,61,60,78
02103-101,../../DataSet/BraTS2024-BraTS-GLI-TrainingData/BraTS-GLI-02103-101/BraTS-GLI-02103-101-t1c.nii.gz,../../DataSet/BraTS2024-BraTS-GLI-TrainingData/BraTS-GLI-02103-101/BraTS-GLI-02103-101-t2w.nii.gz,../../DataSet/BraTS2024-BraTS-GLI-TrainingData/BraTS-GLI-02103-101/BraTS-GLI-02103-101-t2f.nii.gz,../../DataSet/BraTS2024-BraTS-GLI-TrainingData/BraTS-GLI-02103-101/BraTS-GLI-02103-101-t1n.nii.gz,../../DataSet/BraTS2024-BraTS-GLI-TrainingData/BraTS-GLI-02103-101/BraTS-GLI-02103-101-seg.nii.gz,108,148,70,83,134,103,178,46,132,51,75,86
02726-100,../../DataSet/BraTS2024-BraTS-GLI-TrainingData/BraTS-GLI-02726-100/BraTS-GLI-02726-100-t1c.nii.gz,../../DataSet/BraTS2024-BraTS-GLI-TrainingData/BraTS-GLI-02726-100/BraTS-GLI-02726-100-t2w.nii.gz,../../DataSet/BraTS2024-BraTS-GLI-TrainingData/BraTS-GLI-02726-100/BraTS-GLI-02726-100-t2f.nii.gz,../../DataSet/BraTS2024-BraTS-GLI-TrainingData/BraTS-GLI-02726-100/BraTS-GLI-02726-100-t1n.nii.gz,../../DataSet/BraTS2024-BraTS-GLI-TrainingData/BraTS-GLI-02726-100/BraTS-GLI-02726-100-seg.nii.gz,71,132,121,50,111,97,165,87,152,61,68,65
02910-101,../../DataSet/BraTS2024-BraTS-GLI-TrainingData/BraTS-GLI-02910-101/BraTS-GLI-02910-101-t1c.nii.gz,../../DataSet/BraTS2024-BraTS-GLI-TrainingData/BraTS-GLI-02910-101/BraTS-GLI-02910-101-t2w.nii.gz,../../DataSet/BraTS2024-BraTS-GLI-TrainingData/BraTS-GLI-02910-101/BraTS-GLI-02910-101-t2f.nii.gz,../../DataSet/BraTS2024-BraTS-GLI-TrainingData/BraTS-GLI-02910-101/BraTS-GLI-02910-101-t1n.nii.gz,../../DataSet/BraTS2024-BraTS-GLI-TrainingData/BraTS-GLI-02910-101/BraTS-GLI-02910-101-seg.nii.gz,125,129,77,96,151,95,164,51,103,55,69,52
02072-104,../../DataSet/BraTS2024-BraTS-GLI-TrainingData/BraTS-GLI-02072-104/BraTS-GLI-02072-104-t1c.nii.gz,../../DataSet/BraTS2024-BraTS-GLI-TrainingData/BraTS-GLI-02072-104/BraTS-GLI-02072-104-t2w.nii.gz,../../DataSet/BraTS2024-BraTS-GLI-TrainingData/BraTS-GLI-02072-104/BraTS-GLI-02072-104-t2f.nii.gz,../../DataSet/BraTS2024-BraTS-GLI-TrainingData/BraTS-GLI-02072-104/BraTS-GLI-02072-104-t1n.nii.gz,../../DataSet/BraTS2024-BraTS-GLI-TrainingData/BraTS-GLI-02072-104/BraTS-GLI-02072-104-seg.nii.gz,54,103,84,32,81,63,140,50,132,49,77,82
02848-101,../../DataSet/BraTS2024-BraTS-GLI-TrainingData/BraTS-GLI-02848-101/BraTS-GLI-02848-101-t1c.nii.gz,../../DataSet/BraTS2024-BraTS-GLI-TrainingData/BraTS-GLI-02848-101/BraTS-GLI-02848-101-t2w.nii.gz,../../DataSet/BraTS2024-BraTS-GLI-TrainingData/BraTS-GLI-02848-101/BraTS-GLI-02848-101-t2f.nii.gz,../../DataSet/BraTS2024-BraTS-GLI-TrainingData/BraTS-GLI-02848-101/BraTS-GLI-02848-101-t1n.nii.gz,../../DataSet/BraTS2024-BraTS-GLI-TrainingData/BraTS-GLI-02848-101/BraTS-GLI-02848-101-seg.nii.gz,72,85,115,34,127,38,133,84,154,93,95,70
02899-101,../../DataSet/BraTS2024-BraTS-GLI-TrainingData/BraTS-GLI-02899-101/BraTS-GLI-02899-101-t1c.nii.gz,../../DataSet/BraTS2024-BraTS-GLI-TrainingData/BraTS-GLI-02899-101/BraTS-GLI-02899-101-t2w.nii.gz,../../DataSet/BraTS2024-BraTS-GLI-TrainingData/BraTS-GLI-02899-101/BraTS-GLI-02899-101-t2f.nii.gz,../../DataSet/BraTS2024-BraTS-GLI-TrainingData/BraTS-GLI-02899-101/BraTS-GLI-02899-101-t1n.nii.gz,../../DataSet/BraTS2024-BraTS-GLI-TrainingData/BraTS-GLI-02899-101/BraTS-GLI-02899-101-seg.nii.gz,108,105,122,59,144,59,140,82,153,85,81,71
02844-100,../../DataSet/BraTS2024-BraTS-GLI-TrainingData/BraTS-GLI-02844-100/BraTS-GLI-02844-100-t1c.nii.gz,../../DataSet/BraTS2024-BraTS-GLI-TrainingData/BraTS-GLI-02844-100/BraTS-GLI-02844-100-t2w.nii.gz,../../DataSet/BraTS2024-BraTS-GLI-TrainingData/BraTS-GLI-02844-100/BraTS-GLI-02844-100-t2f.nii.gz,../../DataSet/BraTS2024-BraTS-GLI-TrainingData/BraTS-GLI-02844-100/BraTS-GLI-02844-100-t1n.nii.gz,../../DataSet/BraTS2024-BraTS-GLI-TrainingData/BraTS-GLI-02844-100/BraTS-GLI-02844-100-seg.nii.gz,137,119,103,121,150,104,136,88,122,29,32,34
02721-100,../../DataSet/BraTS2024-BraTS-GLI-TrainingData/BraTS-GLI-02721-100/BraTS-GLI-02721-100-t1c.nii.gz,../../DataSet/BraTS2024-BraTS-GLI-TrainingData/BraTS-GLI-02721-100/BraTS-GLI-02721-100-t2w.nii.gz,../../DataSet/BraTS2024-BraTS-GLI-TrainingData/BraTS-GLI-02721-100/BraTS-GLI-02721-100-t2f.nii.gz,../../DataSet/BraTS2024-BraTS-GLI-TrainingData/BraTS-GLI-02721-100/BraTS-GLI-02721-100-t1n.nii.gz,../../DataSet/BraTS2024-BraTS-GLI-TrainingData/BraTS-GLI-02721-100/BraTS-GLI-02721-100-seg.nii.gz,110,167,99,94,132,141,195,68,139,38,54,71
02086-100,../../DataSet/BraTS2024-BraTS-GLI-TrainingData/BraTS-GLI-02086-100/BraTS-GLI-02086-100-t1c.nii.gz,../../DataSet/BraTS2024-BraTS-GLI-TrainingData/BraTS-GLI-02086-100/BraTS-GLI-02086-100-t2w.nii.gz,../../DataSet/BraTS2024-BraTS-GLI-TrainingData/BraTS-GLI-02086-100/BraTS-GLI-02086-100-t2f.nii.gz,../../DataSet/BraTS2024-BraTS-GLI-TrainingData/BraTS-GLI-02086-100/BraTS-GLI-02086-100-t1n.nii.gz,../../DataSet/BraTS2024-BraTS-GLI-TrainingData/BraTS-GLI-02086-100/BraTS-GLI-02086-100-seg.nii.gz,129,90,113,98,155,53,131,79,153,57,78,74
02340-100,../../DataSet/BraTS2024-BraTS-GLI-TrainingData/BraTS-GLI-02340-100/BraTS-GLI-02340-100-t1c.nii.gz,../../DataSet/BraTS2024-BraTS-GLI-TrainingData/BraTS-GLI-02340-100/BraTS-GLI-02340-100-t2w.nii.gz,../../DataSet/BraTS2024-BraTS-GLI-TrainingData/BraTS-GLI-02340-100/BraTS-GLI-02340-100-t2f.nii.gz,../../DataSet/BraTS2024-BraTS-GLI-TrainingData/BraTS-GLI-02340-100/BraTS-GLI-02340-100-t1n.nii.gz,../../DataSet/BraTS2024-BraTS-GLI-TrainingData/BraTS-GLI-02340-100/BraTS-GLI-02340-100-seg.nii.gz,78,144,107,41,129,96,185,62,147,88,89,85
02895-100,../../DataSet/BraTS2024-BraTS-GLI-TrainingData/BraTS-GLI-02895-100/BraTS-GLI-02895-100-t1c.nii.gz,../../DataSet/BraTS2024-BraTS-GLI-TrainingData/BraTS-GLI-02895-100/BraTS-GLI-02895-100-t2w.nii.gz,../../DataSet/BraTS2024-BraTS-GLI-TrainingData/BraTS-GLI-02895-100/BraTS-GLI-02895-100-t2f.nii.gz,../../DataSet/BraTS2024-BraTS-GLI-TrainingData/BraTS-GLI-02895-100/BraTS-GLI-02895-100-t1n.nii.gz,../../DataSet/BraTS2024-BraTS-GLI-TrainingData/BraTS-GLI-02895-100/BraTS-GLI-02895-100-seg.nii.gz,101,98,120,90,115,78,123,99,153,25,45,54
02218-100,../../DataSet/BraTS2024-BraTS-GLI-TrainingData/BraTS-GLI-02218-100/BraTS-GLI-02218-100-t1c.nii.gz,../../DataSet/BraTS2024-BraTS-GLI-TrainingData/BraTS-GLI-02218-100/BraTS-GLI-02218-100-t2w.nii.gz,../../DataSet/BraTS2024-BraTS-GLI-TrainingData/BraTS-GLI-02218-100/BraTS-GLI-02218-100-t2f.nii.gz,../../DataSet/BraTS2024-BraTS-GLI-TrainingData/BraTS-GLI-02218-100/BraTS-GLI-02218-100-t1n.nii.gz,../../DataSet/BraTS2024-BraTS-GLI-TrainingData/BraTS-GLI-02218-100/BraTS-GLI-02218-100-seg.nii.gz,121,124,73,107,136,100,148,58,92,29,48,34
02220-102,../../DataSet/BraTS2024-BraTS-GLI-TrainingData/BraTS-GLI-02220-102/BraTS-GLI-02220-102-t1c.nii.gz,../../DataSet/BraTS2024-BraTS-GLI-TrainingData/BraTS-GLI-02220-102/BraTS-GLI-02220-102-t2w.nii.gz,../../DataSet/BraTS2024-BraTS-GLI-TrainingData/BraTS-GLI-02220-102/BraTS-GLI-02220-102-t2f.nii.gz,../../DataSet/BraTS2024-BraTS-GLI-TrainingData/BraTS-GLI-02220-102/BraTS-GLI-02220-102-t1n.nii.gz,../../DataSet/BraTS2024-BraTS-GLI-TrainingData/BraTS-GLI-02220-102/BraTS-GLI-02220-102-seg.nii.gz,130,117,110,113,149,94,143,84,141,36,49,57
02838-100,../../DataSet/BraTS2024-BraTS-GLI-TrainingData/BraTS-GLI-02838-100/BraTS-GLI-02838-100-t1c.nii.gz,../../DataSet/BraTS2024-BraTS-GLI-TrainingData/BraTS-GLI-02838-100/BraTS-GLI-02838-100-t2w.nii.gz,../../DataSet/BraTS2024-BraTS-GLI-TrainingData/BraTS-GLI-02838-100/BraTS-GLI-02838-100-t2f.nii.gz,../../DataSet/BraTS2024-BraTS-GLI-TrainingData/BraTS-GLI-02838-100/BraTS-GLI-02838-100-t1n.nii.gz,../../DataSet/BraTS2024-BraTS-GLI-TrainingData/BraTS-GLI-02838-100/BraTS-GLI-02838-100-seg.nii.gz,128,139,100,104,152,96,173,62,130,48,77,68
00008-100,../../DataSet/BraTS2024-BraTS-GLI-TrainingData/BraTS-GLI-00008-100/BraTS-GLI-00008-100-t1c.nii.gz,../../DataSet/BraTS2024-BraTS-GLI-TrainingData/BraTS-GLI-00008-100/BraTS-GLI-00008-100-t2w.nii.gz,../../DataSet/BraTS2024-BraTS-GLI-TrainingData/BraTS-GLI-00008-100/BraTS-GLI-00008-100-t2f.nii.gz,../../DataSet/BraTS2024-BraTS-GLI-TrainingData/BraTS-GLI-00008-100/BraTS-GLI-00008-100-t1n.nii.gz,../../DataSet/BraTS2024-BraTS-GLI-TrainingData/BraTS-GLI-00008-100/BraTS-GLI-00008-100-seg.nii.gz,49,67,77,30,74,39,95,56,100,44,56,44
02178-101,../../DataSet/BraTS2024-BraTS-GLI-TrainingData/BraTS-GLI-02178-101/BraTS-GLI-02178-101-t1c.nii.gz,../../DataSet/BraTS2024-BraTS-GLI-TrainingData/BraTS-GLI-02178-101/BraTS-GLI-02178-101-t2w.nii.gz,../../DataSet/BraTS2024-BraTS-GLI-TrainingData/BraTS-GLI-02178-101/BraTS-GLI-02178-101-t2f.nii.gz,../../DataSet/BraTS2024-BraTS-GLI-TrainingData/BraTS-GLI-02178-101/BraTS-GLI-02178-101-t1n.nii.gz,../../DataSet/BraTS2024-BraTS-GLI-TrainingData/BraTS-GLI-02178-101/BraTS-GLI-02178-101-seg.nii.gz,111,126,124,94,135,79,163,90,151,41,84,61
00469-100,../../DataSet/BraTS2024-BraTS-GLI-TrainingData/BraTS-GLI-00469-100/BraTS-GLI-00469-100-t1c.nii.gz,../../DataSet/BraTS2024-BraTS-GLI-TrainingData/BraTS-GLI-00469-100/BraTS-GLI-00469-100-t2w.nii.gz,../../DataSet/BraTS2024-BraTS-GLI-TrainingData/BraTS-GLI-00469-100/BraTS-GLI-00469-100-t2f.nii.gz,../../DataSet/BraTS2024-BraTS-GLI-TrainingData/BraTS-GLI-00469-100/BraTS-GLI-00469-100-t1n.nii.gz,../../DataSet/BraTS2024-BraTS-GLI-TrainingData/BraTS-GLI-00469-100/BraTS-GLI-00469-100-seg.nii.gz,118,85,105,83,153,34,129,57,147,70,95,90
02605-100,../../DataSet/BraTS2024-BraTS-GLI-TrainingData/BraTS-GLI-02605-100/BraTS-GLI-02605-100-t1c.nii.gz,../../DataSet/BraTS2024-BraTS-GLI-TrainingData/BraTS-GLI-02605-100/BraTS-GLI-02605-100-t2w.nii.gz,../../DataSet/BraTS2024-BraTS-GLI-TrainingData/BraTS-GLI-02605-100/BraTS-GLI-02605-100-t2f.nii.gz,../../DataSet/BraTS2024-BraTS-GLI-TrainingData/BraTS-GLI-02605-100/BraTS-GLI-02605-100-t1n.nii.gz,../../DataSet/BraTS2024-BraTS-GLI-TrainingData/BraTS-GLI-02605-100/BraTS-GLI-02605-100-seg.nii.gz,74,65,108,45,96,35,97,78,139,51,62,61
02833-101,../../DataSet/BraTS2024-BraTS-GLI-TrainingData/BraTS-GLI-02833-101/BraTS-GLI-02833-101-t1c.nii.gz,../../DataSet/BraTS2024-BraTS-GLI-TrainingData/BraTS-GLI-02833-101/BraTS-GLI-02833-101-t2w.nii.gz,../../DataSet/BraTS2024-BraTS-GLI-TrainingData/BraTS-GLI-02833-101/BraTS-GLI-02833-101-t2f.nii.gz,../../DataSet/BraTS2024-BraTS-GLI-TrainingData/BraTS-GLI-02833-101/BraTS-GLI-02833-101-t1n.nii.gz,../../DataSet/BraTS2024-BraTS-GLI-TrainingData/BraTS-GLI-02833-101/BraTS-GLI-02833-101-seg.nii.gz,73,139,81,36,130,84,177,47,129,94,93,82
02756-101,../../DataSet/BraTS2024-BraTS-GLI-TrainingData/BraTS-GLI-02756-101/BraTS-GLI-02756-101-t1c.nii.gz,../../DataSet/BraTS2024-BraTS-GLI-TrainingData/BraTS-GLI-02756-101/BraTS-GLI-02756-101-t2w.nii.gz,../../DataSet/BraTS2024-BraTS-GLI-TrainingData/BraTS-GLI-02756-101/BraTS-GLI-02756-101-t2f.nii.gz,../../DataSet/BraTS2024-BraTS-GLI-TrainingData/BraTS-GLI-02756-101/BraTS-GLI-02756-101-t1n.nii.gz,../../DataSet/BraTS2024-BraTS-GLI-TrainingData/BraTS-GLI-02756-101/BraTS-GLI-02756-101-seg.nii.gz,60,130,101,33,90,80,169,73,133,57,89,60
02375-100,../../DataSet/BraTS2024-BraTS-GLI-TrainingData/BraTS-GLI-02375-100/BraTS-GLI-02375-100-t1c.nii.gz,../../DataSet/BraTS2024-BraTS-GLI-TrainingData/BraTS-GLI-02375-100/BraTS-GLI-02375-100-t2w.nii.gz,../../DataSet/BraTS2024-BraTS-GLI-TrainingData/BraTS-GLI-02375-100/BraTS-GLI-02375-100-t2f.nii.gz,../../DataSet/BraTS2024-BraTS-GLI-TrainingData/BraTS-GLI-02375-100/BraTS-GLI-02375-100-t1n.nii.gz,../../DataSet/BraTS2024-BraTS-GLI-TrainingData/BraTS-GLI-02375-100/BraTS-GLI-02375-100-seg.nii.gz,60,93,79,30,98,52,142,52,115,68,90,63
02131-101,../../DataSet/BraTS2024-BraTS-GLI-TrainingData/BraTS-GLI-02131-101/BraTS-GLI-02131-101-t1c.nii.gz,../../DataSet/BraTS2024-BraTS-GLI-TrainingData/BraTS-GLI-02131-101/BraTS-GLI-02131-101-t2w.nii.gz,../../DataSet/BraTS2024-BraTS-GLI-TrainingData/BraTS-GLI-02131-101/BraTS-GLI-02131-101-t2f.nii.gz,../../DataSet/BraTS2024-BraTS-GLI-TrainingData/BraTS-GLI-02131-101/BraTS-GLI-02131-101-t1n.nii.gz,../../DataSet/BraTS2024-BraTS-GLI-TrainingData/BraTS-GLI-02131-101/BraTS-GLI-02131-101-seg.nii.gz,49,100,68,28,81,75,126,51,91,53,51,40
03007-101,../../DataSet/BraTS2024-BraTS-GLI-TrainingData/BraTS-GLI-03007-101/BraTS-GLI-03007-101-t1c.nii.gz,../../DataSet/BraTS2024-BraTS-GLI-TrainingData/BraTS-GLI-03007-101/BraTS-GLI-03007-101-t2w.nii.gz,../../DataSet/BraTS2024-BraTS-GLI-TrainingData/BraTS-GLI-03007-101/BraTS-GLI-03007-101-t2f.nii.gz,../../DataSet/BraTS2024-BraTS-GLI-TrainingData/BraTS-GLI-03007-101/BraTS-GLI-03007-101-t1n.nii.gz,../../DataSet/BraTS2024-BraTS-GLI-TrainingData/BraTS-GLI-03007-101/BraTS-GLI-03007-101-seg.nii.gz,49,116,69,23,82,70,150,45,112,59,80,67
02062-100,../../DataSet/BraTS2024-BraTS-GLI-TrainingData/BraTS-GLI-02062-100/BraTS-GLI-02062-100-t1c.nii.gz,../../DataSet/BraTS2024-BraTS-GLI-TrainingData/BraTS-GLI-02062-100/BraTS-GLI-02062-100-t2w.nii.gz,../../DataSet/BraTS2024-BraTS-GLI-TrainingData/BraTS-GLI-02062-100/BraTS-GLI-02062-100-t2f.nii.gz,../../DataSet/BraTS2024-BraTS-GLI-TrainingData/BraTS-GLI-02062-100/BraTS-GLI-02062-100-t1n.nii.gz,../../DataSet/BraTS2024-BraTS-GLI-TrainingData/BraTS-GLI-02062-100/BraTS-GLI-02062-100-seg.nii.gz,47,87,94,30,76,47,117,64,123,46,70,59
02226-101,../../DataSet/BraTS2024-BraTS-GLI-TrainingData/BraTS-GLI-02226-101/BraTS-GLI-02226-101-t1c.nii.gz,../../DataSet/BraTS2024-BraTS-GLI-TrainingData/BraTS-GLI-02226-101/BraTS-GLI-02226-101-t2w.nii.gz,../../DataSet/BraTS2024-BraTS-GLI-TrainingData/BraTS-GLI-02226-101/BraTS-GLI-02226-101-t2f.nii.gz,../../DataSet/BraTS2024-BraTS-GLI-TrainingData/BraTS-GLI-02226-101/BraTS-GLI-02226-101-t1n.nii.gz,../../DataSet/BraTS2024-BraTS-GLI-TrainingData/BraTS-GLI-02226-101/BraTS-GLI-02226-101-seg.nii.gz,100,132,122,88,118,110,156,98,148,30,46,50
02871-100,../../DataSet/BraTS2024-BraTS-GLI-TrainingData/BraTS-GLI-02871-100/BraTS-GLI-02871-100-t1c.nii.gz,../../DataSet/BraTS2024-BraTS-GLI-TrainingData/BraTS-GLI-02871-100/BraTS-GLI-02871-100-t2w.nii.gz,../../DataSet/BraTS2024-BraTS-GLI-TrainingData/BraTS-GLI-02871-100/BraTS-GLI-02871-100-t2f.nii.gz,../../DataSet/BraTS2024-BraTS-GLI-TrainingData/BraTS-GLI-02871-100/BraTS-GLI-02871-100-t1n.nii.gz,../../DataSet/BraTS2024-BraTS-GLI-TrainingData/BraTS-GLI-02871-100/BraTS-GLI-02871-100-seg.nii.gz,102,141,122,74,124,121,175,97,149,50,54,52
02215-102,../../DataSet/BraTS2024-BraTS-GLI-TrainingData/BraTS-GLI-02215-102/BraTS-GLI-02215-102-t1c.nii.gz,../../DataSet/BraTS2024-BraTS-GLI-TrainingData/BraTS-GLI-02215-102/BraTS-GLI-02215-102-t2w.nii.gz,../../DataSet/BraTS2024-BraTS-GLI-TrainingData/BraTS-GLI-02215-102/BraTS-GLI-02215-102-t2f.nii.gz,../../DataSet/BraTS2024-BraTS-GLI-TrainingData/BraTS-GLI-02215-102/BraTS-GLI-02215-102-t1n.nii.gz,../../DataSet/BraTS2024-BraTS-GLI-TrainingData/BraTS-GLI-02215-102/BraTS-GLI-02215-102-seg.nii.gz,126,89,106,101,150,55,132,76,133,49,77,57
02763-101,../../DataSet/BraTS2024-BraTS-GLI-TrainingData/BraTS-GLI-02763-101/BraTS-GLI-02763-101-t1c.nii.gz,../../DataSet/BraTS2024-BraTS-GLI-TrainingData/BraTS-GLI-02763-101/BraTS-GLI-02763-101-t2w.nii.gz,../../DataSet/BraTS2024-BraTS-GLI-TrainingData/BraTS-GLI-02763-101/BraTS-GLI-02763-101-t2f.nii.gz,../../DataSet/BraTS2024-BraTS-GLI-TrainingData/BraTS-GLI-02763-101/BraTS-GLI-02763-101-t1n.nii.gz,../../DataSet/BraTS2024-BraTS-GLI-TrainingData/BraTS-GLI-02763-101/BraTS-GLI-02763-101-seg.nii.gz,109,121,126,82,133,82,161,103,153,51,79,50
02146-100,../../DataSet/BraTS2024-BraTS-GLI-TrainingData/BraTS-GLI-02146-100/BraTS-GLI-02146-100-t1c.nii.gz,../../DataSet/BraTS2024-BraTS-GLI-TrainingData/BraTS-GLI-02146-100/BraTS-GLI-02146-100-t2w.nii.gz,../../DataSet/BraTS2024-BraTS-GLI-TrainingData/BraTS-GLI-02146-100/BraTS-GLI-02146-100-t2f.nii.gz,../../DataSet/BraTS2024-BraTS-GLI-TrainingData/BraTS-GLI-02146-100/BraTS-GLI-02146-100-t1n.nii.gz,../../DataSet/BraTS2024-BraTS-GLI-TrainingData/BraTS-GLI-02146-100/BraTS-GLI-02146-100-seg.nii.gz,91,65,87,49,141,36,95,55,123,92,59,68
02955-100,../../DataSet/BraTS2024-BraTS-GLI-TrainingData/BraTS-GLI-02955-100/BraTS-GLI-02955-100-t1c.nii.gz,../../DataSet/BraTS2024-BraTS-GLI-TrainingData/BraTS-GLI-02955-100/BraTS-GLI-02955-100-t2w.nii.gz,../../DataSet/BraTS2024-BraTS-GLI-TrainingData/BraTS-GLI-02955-100/BraTS-GLI-02955-100-t2f.nii.gz,../../DataSet/BraTS2024-BraTS-GLI-TrainingData/BraTS-GLI-02955-100/BraTS-GLI-02955-100-t1n.nii.gz,../../DataSet/BraTS2024-BraTS-GLI-TrainingData/BraTS-GLI-02955-100/BraTS-GLI-02955-100-seg.nii.gz,134,103,77,112,151,54,135,56,96,39,81,40
02251-100,../../DataSet/BraTS2024-BraTS-GLI-TrainingData/BraTS-GLI-02251-100/BraTS-GLI-02251-100-t1c.nii.gz,../../DataSet/BraTS2024-BraTS-GLI-TrainingData/BraTS-GLI-02251-100/BraTS-GLI-02251-100-t2w.nii.gz,../../DataSet/BraTS2024-BraTS-GLI-TrainingData/BraTS-GLI-02251-100/BraTS-GLI-02251-100-t2f.nii.gz,../../DataSet/BraTS2024-BraTS-GLI-TrainingData/BraTS-GLI-02251-100/BraTS-GLI-02251-100-t1n.nii.gz,../../DataSet/BraTS2024-BraTS-GLI-TrainingData/BraTS-GLI-02251-100/BraTS-GLI-02251-100-seg.nii.gz,115,69,99,94,146,31,109,56,143,52,78,87
02164-104,../../DataSet/BraTS2024-BraTS-GLI-TrainingData/BraTS-GLI-02164-104/BraTS-GLI-02164-104-t1c.nii.gz,../../DataSet/BraTS2024-BraTS-GLI-TrainingData/BraTS-GLI-02164-104/BraTS-GLI-02164-104-t2w.nii.gz,../../DataSet/BraTS2024-BraTS-GLI-TrainingData/BraTS-GLI-02164-104/BraTS-GLI-02164-104-t2f.nii.gz,../../DataSet/BraTS2024-BraTS-GLI-TrainingData/BraTS-GLI-02164-104/BraTS-GLI-02164-104-t1n.nii.gz,../../DataSet/BraTS2024-BraTS-GLI-TrainingData/BraTS-GLI-02164-104/BraTS-GLI-02164-104-seg.nii.gz,128,83,114,105,150,52,129,81,142,45,77,61
02197-100,../../DataSet/BraTS2024-BraTS-GLI-TrainingData/BraTS-GLI-02197-100/BraTS-GLI-02197-100-t1c.nii.gz,../../DataSet/BraTS2024-BraTS-GLI-TrainingData/BraTS-GLI-02197-100/BraTS-GLI-02197-100-t2w.nii.gz,../../DataSet/BraTS2024-BraTS-GLI-TrainingData/BraTS-GLI-02197-100/BraTS-GLI-02197-100-t2f.nii.gz,../../DataSet/BraTS2024-BraTS-GLI-TrainingData/BraTS-GLI-02197-100/BraTS-GLI-02197-100-t1n.nii.gz,../../DataSet/BraTS2024-BraTS-GLI-TrainingData/BraTS-GLI-02197-100/BraTS-GLI-02197-100-seg.nii.gz,51,97,74,30,76,54,146,38,113,46,92,75
02608-102,../../DataSet/BraTS2024-BraTS-GLI-TrainingData/BraTS-GLI-02608-102/BraTS-GLI-02608-102-t1c.nii.gz,../../DataSet/BraTS2024-BraTS-GLI-TrainingData/BraTS-GLI-02608-102/BraTS-GLI-02608-102-t2w.nii.gz,../../DataSet/BraTS2024-BraTS-GLI-TrainingData/BraTS-GLI-02608-102/BraTS-GLI-02608-102-t2f.nii.gz,../../DataSet/BraTS2024-BraTS-GLI-TrainingData/BraTS-GLI-02608-102/BraTS-GLI-02608-102-t1n.nii.gz,../../DataSet/BraTS2024-BraTS-GLI-TrainingData/BraTS-GLI-02608-102/BraTS-GLI-02608-102-seg.nii.gz,112,64,102,63,147,29,102,64,138,84,73,74
02764-101,../../DataSet/BraTS2024-BraTS-GLI-TrainingData/BraTS-GLI-02764-101/BraTS-GLI-02764-101-t1c.nii.gz,../../DataSet/BraTS2024-BraTS-GLI-TrainingData/BraTS-GLI-02764-101/BraTS-GLI-02764-101-t2w.nii.gz,../../DataSet/BraTS2024-BraTS-GLI-TrainingData/BraTS-GLI-02764-101/BraTS-GLI-02764-101-t2f.nii.gz,../../DataSet/BraTS2024-BraTS-GLI-TrainingData/BraTS-GLI-02764-101/BraTS-GLI-02764-101-t1n.nii.gz,../../DataSet/BraTS2024-BraTS-GLI-TrainingData/BraTS-GLI-02764-101/BraTS-GLI-02764-101-seg.nii.gz,70,171,99,36,114,143,198,68,136,78,55,68
02141-100,../../DataSet/BraTS2024-BraTS-GLI-TrainingData/BraTS-GLI-02141-100/BraTS-GLI-02141-100-t1c.nii.gz,../../DataSet/BraTS2024-BraTS-GLI-TrainingData/BraTS-GLI-02141-100/BraTS-GLI-02141-100-t2w.nii.gz,../../DataSet/BraTS2024-BraTS-GLI-TrainingData/BraTS-GLI-02141-100/BraTS-GLI-02141-100-t2f.nii.gz,../../DataSet/BraTS2024-BraTS-GLI-TrainingData/BraTS-GLI-02141-100/BraTS-GLI-02141-100-t1n.nii.gz,../../DataSet/BraTS2024-BraTS-GLI-TrainingData/BraTS-GLI-02141-100/BraTS-GLI-02141-100-seg.nii.gz,113,99,122,87,145,56,144,95,151,58,88,56
02952-100,../../DataSet/BraTS2024-BraTS-GLI-TrainingData/BraTS-GLI-02952-100/BraTS-GLI-02952-100-t1c.nii.gz,../../DataSet/BraTS2024-BraTS-GLI-TrainingData/BraTS-GLI-02952-100/BraTS-GLI-02952-100-t2w.nii.gz,../../DataSet/BraTS2024-BraTS-GLI-TrainingData/BraTS-GLI-02952-100/BraTS-GLI-02952-100-t2f.nii.gz,../../DataSet/BraTS2024-BraTS-GLI-TrainingData/BraTS-GLI-02952-100/BraTS-GLI-02952-100-t1n.nii.gz,../../DataSet/BraTS2024-BraTS-GLI-TrainingData/BraTS-GLI-02952-100/BraTS-GLI-02952-100-seg.nii.gz,124,124,92,105,150,91,156,61,115,45,65,54
02287-100,../../DataSet/BraTS2024-BraTS-GLI-TrainingData/BraTS-GLI-02287-100/BraTS-GLI-02287-100-t1c.nii.gz,../../DataSet/BraTS2024-BraTS-GLI-TrainingData/BraTS-GLI-02287-100/BraTS-GLI-02287-100-t2w.nii.gz,../../DataSet/BraTS2024-BraTS-GLI-TrainingData/BraTS-GLI-02287-100/BraTS-GLI-02287-100-t2f.nii.gz,../../DataSet/BraTS2024-BraTS-GLI-TrainingData/BraTS-GLI-02287-100/BraTS-GLI-02287-100-t1n.nii.gz,../../DataSet/BraTS2024-BraTS-GLI-TrainingData/BraTS-GLI-02287-100/BraTS-GLI-02287-100-seg.nii.gz,48,104,92,27,77,66,154,59,127,50,88,68
02983-100,../../DataSet/BraTS2024-BraTS-GLI-TrainingData/BraTS-GLI-02983-100/BraTS-GLI-02983-100-t1c.nii.gz,../../DataSet/BraTS2024-BraTS-GLI-TrainingData/BraTS-GLI-02983-100/BraTS-GLI-02983-100-t2w.nii.gz,../../DataSet/BraTS2024-BraTS-GLI-TrainingData/BraTS-GLI-02983-100/BraTS-GLI-02983-100-t2f.nii.gz,../../DataSet/BraTS2024-BraTS-GLI-TrainingData/BraTS-GLI-02983-100/BraTS-GLI-02983-100-t1n.nii.gz,../../DataSet/BraTS2024-BraTS-GLI-TrainingData/BraTS-GLI-02983-100/BraTS-GLI-02983-100-seg.nii.gz,130,109,60,105,151,67,143,44,90,46,76,46
02256-100,../../DataSet/BraTS2024-BraTS-GLI-TrainingData/BraTS-GLI-02256-100/BraTS-GLI-02256-100-t1c.nii.gz,../../DataSet/BraTS2024-BraTS-GLI-TrainingData/BraTS-GLI-02256-100/BraTS-GLI-02256-100-t2w.nii.gz,../../DataSet/BraTS2024-BraTS-GLI-TrainingData/BraTS-GLI-02256-100/BraTS-GLI-02256-100-t2f.nii.gz,../../DataSet/BraTS2024-BraTS-GLI-TrainingData/BraTS-GLI-02256-100/BraTS-GLI-02256-100-t1n.nii.gz,../../DataSet/BraTS2024-BraTS-GLI-TrainingData/BraTS-GLI-02256-100/BraTS-GLI-02256-100-seg.nii.gz,43,86,91,24,71,45,141,71,117,47,96,46
02637-100,../../DataSet/BraTS2024-BraTS-GLI-TrainingData/BraTS-GLI-02637-100/BraTS-GLI-02637-100-t1c.nii.gz,../../DataSet/BraTS2024-BraTS-GLI-TrainingData/BraTS-GLI-02637-100/BraTS-GLI-02637-100-t2w.nii.gz,../../DataSet/BraTS2024-BraTS-GLI-TrainingData/BraTS-GLI-02637-100/BraTS-GLI-02637-100-t2f.nii.gz,../../DataSet/BraTS2024-BraTS-GLI-TrainingData/BraTS-GLI-02637-100/BraTS-GLI-02637-100-t1n.nii.gz,../../DataSet/BraTS2024-BraTS-GLI-TrainingData/BraTS-GLI-02637-100/BraTS-GLI-02637-100-seg.nii.gz,63,124,120,39,86,107,146,104,139,47,39,35
02136-101,../../DataSet/BraTS2024-BraTS-GLI-TrainingData/BraTS-GLI-02136-101/BraTS-GLI-02136-101-t1c.nii.gz,../../DataSet/BraTS2024-BraTS-GLI-TrainingData/BraTS-GLI-02136-101/BraTS-GLI-02136-101-t2w.nii.gz,../../DataSet/BraTS2024-BraTS-GLI-TrainingData/BraTS-GLI-02136-101/BraTS-GLI-02136-101-t2f.nii.gz,../../DataSet/BraTS2024-BraTS-GLI-TrainingData/BraTS-GLI-02136-101/BraTS-GLI-02136-101-t1n.nii.gz,../../DataSet/BraTS2024-BraTS-GLI-TrainingData/BraTS-GLI-02136-101/BraTS-GLI-02136-101-seg.nii.gz,58,134,101,35,85,113,156,70,143,50,43,73
00046-100,../../DataSet/BraTS2024-BraTS-GLI-TrainingData/BraTS-GLI-00046-100/BraTS-GLI-00046-100-t1c.nii.gz,../../DataSet/BraTS2024-BraTS-GLI-TrainingData/BraTS-GLI-00046-100/BraTS-GLI-00046-100-t2w.nii.gz,../../DataSet/BraTS2024-BraTS-GLI-TrainingData/BraTS-GLI-00046-100/BraTS-GLI-00046-100-t2f.nii.gz,../../DataSet/BraTS2024-BraTS-GLI-TrainingData/BraTS-GLI-00046-100/BraTS-GLI-00046-100-t1n.nii.gz,../../DataSet/BraTS2024-BraTS-GLI-TrainingData/BraTS-GLI-00046-100/BraTS-GLI-00046-100-seg.nii.gz,59,94,119,40,80,58,148,87,148,40,90,61
02219-103,../../DataSet/BraTS2024-BraTS-GLI-TrainingData/BraTS-GLI-02219-103/BraTS-GLI-02219-103-t1c.nii.gz,../../DataSet/BraTS2024-BraTS-GLI-TrainingData/BraTS-GLI-02219-103/BraTS-GLI-02219-103-t2w.nii.gz,../../DataSet/BraTS2024-BraTS-GLI-TrainingData/BraTS-GLI-02219-103/BraTS-GLI-02219-103-t2f.nii.gz,../../DataSet/BraTS2024-BraTS-GLI-TrainingData/BraTS-GLI-02219-103/BraTS-GLI-02219-103-t1n.nii.gz,../../DataSet/BraTS2024-BraTS-GLI-TrainingData/BraTS-GLI-02219-103/BraTS-GLI-02219-103-seg.nii.gz,55,118,117,36,71,99,136,100,140,35,37,40
02876-100,../../DataSet/BraTS2024-BraTS-GLI-TrainingData/BraTS-GLI-02876-100/BraTS-GLI-02876-100-t1c.nii.gz,../../DataSet/BraTS2024-BraTS-GLI-TrainingData/BraTS-GLI-02876-100/BraTS-GLI-02876-100-t2w.nii.gz,../../DataSet/BraTS2024-BraTS-GLI-TrainingData/BraTS-GLI-02876-100/BraTS-GLI-02876-100-t2f.nii.gz,../../DataSet/BraTS2024-BraTS-GLI-TrainingData/BraTS-GLI-02876-100/BraTS-GLI-02876-100-t1n.nii.gz,../../DataSet/BraTS2024-BraTS-GLI-TrainingData/BraTS-GLI-02876-100/BraTS-GLI-02876-100-seg.nii.gz,71,57,96,35,127,28,105,52,139,92,77,87
02105-102,../../DataSet/BraTS2024-BraTS-GLI-TrainingData/BraTS-GLI-02105-102/BraTS-GLI-02105-102-t1c.nii.gz,../../DataSet/BraTS2024-BraTS-GLI-TrainingData/BraTS-GLI-02105-102/BraTS-GLI-02105-102-t2w.nii.gz,../../DataSet/BraTS2024-BraTS-GLI-TrainingData/BraTS-GLI-02105-102/BraTS-GLI-02105-102-t2f.nii.gz,../../DataSet/BraTS2024-BraTS-GLI-TrainingData/BraTS-GLI-02105-102/BraTS-GLI-02105-102-t1n.nii.gz,../../DataSet/BraTS2024-BraTS-GLI-TrainingData/BraTS-GLI-02105-102/BraTS-GLI-02105-102-seg.nii.gz,74,82,131,51,90,63,98,84,153,39,35,69
02957-101,../../DataSet/BraTS2024-BraTS-GLI-TrainingData/BraTS-GLI-02957-101/BraTS-GLI-02957-101-t1c.nii.gz,../../DataSet/BraTS2024-BraTS-GLI-TrainingData/BraTS-GLI-02957-101/BraTS-GLI-02957-101-t2w.nii.gz,../../DataSet/BraTS2024-BraTS-GLI-TrainingData/BraTS-GLI-02957-101/BraTS-GLI-02957-101-t2f.nii.gz,../../DataSet/BraTS2024-BraTS-GLI-TrainingData/BraTS-GLI-02957-101/BraTS-GLI-02957-101-t1n.nii.gz,../../DataSet/BraTS2024-BraTS-GLI-TrainingData/BraTS-GLI-02957-101/BraTS-GLI-02957-101-seg.nii.gz,80,175,101,66,92,158,190,83,124,26,32,41
02300-100,../../DataSet/BraTS2024-BraTS-GLI-TrainingData/BraTS-GLI-02300-100/BraTS-GLI-02300-100-t1c.nii.gz,../../DataSet/BraTS2024-BraTS-GLI-TrainingData/BraTS-GLI-02300-100/BraTS-GLI-02300-100-t2w.nii.gz,../../DataSet/BraTS2024-BraTS-GLI-TrainingData/BraTS-GLI-02300-100/BraTS-GLI-02300-100-t2f.nii.gz,../../DataSet/BraTS2024-BraTS-GLI-TrainingData/BraTS-GLI-02300-100/BraTS-GLI-02300-100-t1n.nii.gz,../../DataSet/BraTS2024-BraTS-GLI-TrainingData/BraTS-GLI-02300-100/BraTS-GLI-02300-100-seg.nii.gz,94,150,119,56,131,117,186,95,148,75,69,53
02144-101,../../DataSet/BraTS2024-BraTS-GLI-TrainingData/BraTS-GLI-02144-101/BraTS-GLI-02144-101-t1c.nii.gz,../../DataSet/BraTS2024-BraTS-GLI-TrainingData/BraTS-GLI-02144-101/BraTS-GLI-02144-101-t2w.nii.gz,../../DataSet/BraTS2024-BraTS-GLI-TrainingData/BraTS-GLI-02144-101/BraTS-GLI-02144-101-t2f.nii.gz,../../DataSet/BraTS2024-BraTS-GLI-TrainingData/BraTS-GLI-02144-101/BraTS-GLI-02144-101-t1n.nii.gz,../../DataSet/BraTS2024-BraTS-GLI-TrainingData/BraTS-GLI-02144-101/BraTS-GLI-02144-101-seg.nii.gz,112,116,111,81,148,85,151,80,147,67,66,67
02761-100,../../DataSet/BraTS2024-BraTS-GLI-TrainingData/BraTS-GLI-02761-100/BraTS-GLI-02761-100-t1c.nii.gz,../../DataSet/BraTS2024-BraTS-GLI-TrainingData/BraTS-GLI-02761-100/BraTS-GLI-02761-100-t2w.nii.gz,../../DataSet/BraTS2024-BraTS-GLI-TrainingData/BraTS-GLI-02761-100/BraTS-GLI-02761-100-t2f.nii.gz,../../DataSet/BraTS2024-BraTS-GLI-TrainingData/BraTS-GLI-02761-100/BraTS-GLI-02761-100-t1n.nii.gz,../../DataSet/BraTS2024-BraTS-GLI-TrainingData/BraTS-GLI-02761-100/BraTS-GLI-02761-100-seg.nii.gz,138,80,67,125,152,60,102,57,79,27,42,22
02632-101,../../DataSet/BraTS2024-BraTS-GLI-TrainingData/BraTS-GLI-02632-101/BraTS-GLI-02632-101-t1c.nii.gz,../../DataSet/BraTS2024-BraTS-GLI-TrainingData/BraTS-GLI-02632-101/BraTS-GLI-02632-101-t2w.nii.gz,../../DataSet/BraTS2024-BraTS-GLI-TrainingData/BraTS-GLI-02632-101/BraTS-GLI-02632-101-t2f.nii.gz,../../DataSet/BraTS2024-BraTS-GLI-TrainingData/BraTS-GLI-02632-101/BraTS-GLI-02632-101-t1n.nii.gz,../../DataSet/BraTS2024-BraTS-GLI-TrainingData/BraTS-GLI-02632-101/BraTS-GLI-02632-101-seg.nii.gz,122,52,90,104,141,32,82,71,108,37,50,37
02195-101,../../DataSet/BraTS2024-BraTS-GLI-TrainingData/BraTS-GLI-02195-101/BraTS-GLI-02195-101-t1c.nii.gz,../../DataSet/BraTS2024-BraTS-GLI-TrainingData/BraTS-GLI-02195-101/BraTS-GLI-02195-101-t2w.nii.gz,../../DataSet/BraTS2024-BraTS-GLI-TrainingData/BraTS-GLI-02195-101/BraTS-GLI-02195-101-t2f.nii.gz,../../DataSet/BraTS2024-BraTS-GLI-TrainingData/BraTS-GLI-02195-101/BraTS-GLI-02195-101-t1n.nii.gz,../../DataSet/BraTS2024-BraTS-GLI-TrainingData/BraTS-GLI-02195-101/BraTS-GLI-02195-101-seg.nii.gz,122,129,59,88,152,84,173,35,85,64,89,50
00506-101,../../DataSet/BraTS2024-BraTS-GLI-TrainingData/BraTS-GLI-00506-101/BraTS-GLI-00506-101-t1c.nii.gz,../../DataSet/BraTS2024-BraTS-GLI-TrainingData/BraTS-GLI-00506-101/BraTS-GLI-00506-101-t2w.nii.gz,../../DataSet/BraTS2024-BraTS-GLI-TrainingData/BraTS-GLI-00506-101/BraTS-GLI-00506-101-t2f.nii.gz,../../DataSet/BraTS2024-BraTS-GLI-TrainingData/BraTS-GLI-00506-101/BraTS-GLI-00506-101-t1n.nii.gz,../../DataSet/BraTS2024-BraTS-GLI-TrainingData/BraTS-GLI-00506-101/BraTS-GLI-00506-101-seg.nii.gz,76,72,123,46,123,35,104,91,154,77,69,63
02804-100,../../DataSet/BraTS2024-BraTS-GLI-TrainingData/BraTS-GLI-02804-100/BraTS-GLI-02804-100-t1c.nii.gz,../../DataSet/BraTS2024-BraTS-GLI-TrainingData/BraTS-GLI-02804-100/BraTS-GLI-02804-100-t2w.nii.gz,../../DataSet/BraTS2024-BraTS-GLI-TrainingData/BraTS-GLI-02804-100/BraTS-GLI-02804-100-t2f.nii.gz,../../DataSet/BraTS2024-BraTS-GLI-TrainingData/BraTS-GLI-02804-100/BraTS-GLI-02804-100-t1n.nii.gz,../../DataSet/BraTS2024-BraTS-GLI-TrainingData/BraTS-GLI-02804-100/BraTS-GLI-02804-100-seg.nii.gz,122,74,93,88,151,33,124,58,133,63,91,75
02289-100,../../DataSet/BraTS2024-BraTS-GLI-TrainingData/BraTS-GLI-02289-100/BraTS-GLI-02289-100-t1c.nii.gz,../../DataSet/BraTS2024-BraTS-GLI-TrainingData/BraTS-GLI-02289-100/BraTS-GLI-02289-100-t2w.nii.gz,../../DataSet/BraTS2024-BraTS-GLI-TrainingData/BraTS-GLI-02289-100/BraTS-GLI-02289-100-t2f.nii.gz,../../DataSet/BraTS2024-BraTS-GLI-TrainingData/BraTS-GLI-02289-100/BraTS-GLI-02289-100-t1n.nii.gz,../../DataSet/BraTS2024-BraTS-GLI-TrainingData/BraTS-GLI-02289-100/BraTS-GLI-02289-100-seg.nii.gz,116,121,104,87,140,80,157,74,128,53,77,54
02258-100,../../DataSet/BraTS2024-BraTS-GLI-TrainingData/BraTS-GLI-02258-100/BraTS-GLI-02258-100-t1c.nii.gz,../../DataSet/BraTS2024-BraTS-GLI-TrainingData/BraTS-GLI-02258-100/BraTS-GLI-02258-100-t2w.nii.gz,../../DataSet/BraTS2024-BraTS-GLI-TrainingData/BraTS-GLI-02258-100/BraTS-GLI-02258-100-t2f.nii.gz,../../DataSet/BraTS2024-BraTS-GLI-TrainingData/BraTS-GLI-02258-100/BraTS-GLI-02258-100-t1n.nii.gz,../../DataSet/BraTS2024-BraTS-GLI-TrainingData/BraTS-GLI-02258-100/BraTS-GLI-02258-100-seg.nii.gz,101,149,118,58,129,106,184,82,155,71,78,73
02138-101,../../DataSet/BraTS2024-BraTS-GLI-TrainingData/BraTS-GLI-02138-101/BraTS-GLI-02138-101-t1c.nii.gz,../../DataSet/BraTS2024-BraTS-GLI-TrainingData/BraTS-GLI-02138-101/BraTS-GLI-02138-101-t2w.nii.gz,../../DataSet/BraTS2024-BraTS-GLI-TrainingData/BraTS-GLI-02138-101/BraTS-GLI-02138-101-t2f.nii.gz,../../DataSet/BraTS2024-BraTS-GLI-TrainingData/BraTS-GLI-02138-101/BraTS-GLI-02138-101-t1n.nii.gz,../../DataSet/BraTS2024-BraTS-GLI-TrainingData/BraTS-GLI-02138-101/BraTS-GLI-02138-101-seg.nii.gz,109,116,119,91,143,65,153,89,147,52,88,58
02217-103,../../DataSet/BraTS2024-BraTS-GLI-TrainingData/BraTS-GLI-02217-103/BraTS-GLI-02217-103-t1c.nii.gz,../../DataSet/BraTS2024-BraTS-GLI-TrainingData/BraTS-GLI-02217-103/BraTS-GLI-02217-103-t2w.nii.gz,../../DataSet/BraTS2024-BraTS-GLI-TrainingData/BraTS-GLI-02217-103/BraTS-GLI-02217-103-t2f.nii.gz,../../DataSet/BraTS2024-BraTS-GLI-TrainingData/BraTS-GLI-02217-103/BraTS-GLI-02217-103-t1n.nii.gz,../../DataSet/BraTS2024-BraTS-GLI-TrainingData/BraTS-GLI-02217-103/BraTS-GLI-02217-103-seg.nii.gz,129,126,92,112,149,102,149,68,113,37,47,45
02878-100,../../DataSet/BraTS2024-BraTS-GLI-TrainingData/BraTS-GLI-02878-100/BraTS-GLI-02878-100-t1c.nii.gz,../../DataSet/BraTS2024-BraTS-GLI-TrainingData/BraTS-GLI-02878-100/BraTS-GLI-02878-100-t2w.nii.gz,../../DataSet/BraTS2024-BraTS-GLI-TrainingData/BraTS-GLI-02878-100/BraTS-GLI-02878-100-t2f.nii.gz,../../DataSet/BraTS2024-BraTS-GLI-TrainingData/BraTS-GLI-02878-100/BraTS-GLI-02878-100-t1n.nii.gz,../../DataSet/BraTS2024-BraTS-GLI-TrainingData/BraTS-GLI-02878-100/BraTS-GLI-02878-100-seg.nii.gz,68,149,97,47,102,102,186,66,130,55,84,64
02206-104,../../DataSet/BraTS2024-BraTS-GLI-TrainingData/BraTS-GLI-02206-104/BraTS-GLI-02206-104-t1c.nii.gz,../../DataSet/BraTS2024-BraTS-GLI-TrainingData/BraTS-GLI-02206-104/BraTS-GLI-02206-104-t2w.nii.gz,../../DataSet/BraTS2024-BraTS-GLI-TrainingData/BraTS-GLI-02206-104/BraTS-GLI-02206-104-t2f.nii.gz,../../DataSet/BraTS2024-BraTS-GLI-TrainingData/BraTS-GLI-02206-104/BraTS-GLI-02206-104-t1n.nii.gz,../../DataSet/BraTS2024-BraTS-GLI-TrainingData/BraTS-GLI-02206-104/BraTS-GLI-02206-104-seg.nii.gz,76,74,102,55,98,45,116,58,132,43,71,74
02873-101,../../DataSet/BraTS2024-BraTS-GLI-TrainingData/BraTS-GLI-02873-101/BraTS-GLI-02873-101-t1c.nii.gz,../../DataSet/BraTS2024-BraTS-GLI-TrainingData/BraTS-GLI-02873-101/BraTS-GLI-02873-101-t2w.nii.gz,../../DataSet/BraTS2024-BraTS-GLI-TrainingData/BraTS-GLI-02873-101/BraTS-GLI-02873-101-t2f.nii.gz,../../DataSet/BraTS2024-BraTS-GLI-TrainingData/BraTS-GLI-02873-101/BraTS-GLI-02873-101-t1n.nii.gz,../../DataSet/BraTS2024-BraTS-GLI-TrainingData/BraTS-GLI-02873-101/BraTS-GLI-02873-101-seg.nii.gz,132,113,65,107,152,57,149,44,86,45,92,42
02224-100,../../DataSet/BraTS2024-BraTS-GLI-TrainingData/BraTS-GLI-02224-100/BraTS-GLI-02224-100-t1c.nii.gz,../../DataSet/BraTS2024-BraTS-GLI-TrainingData/BraTS-GLI-02224-100/BraTS-GLI-02224-100-t2w.nii.gz,../../DataSet/BraTS2024-BraTS-GLI-TrainingData/BraTS-GLI-02224-100/BraTS-GLI-02224-100-t2f.nii.gz,../../DataSet/BraTS2024-BraTS-GLI-TrainingData/BraTS-GLI-02224-100/BraTS-GLI-02224-100-t1n.nii.gz,../../DataSet/BraTS2024-BraTS-GLI-TrainingData/BraTS-GLI-02224-100/BraTS-GLI-02224-100-seg.nii.gz,95,98,49,67,118,71,116,31,67,51,45,36
02093-105,../../DataSet/BraTS2024-BraTS-GLI-TrainingData/BraTS-GLI-02093-105/BraTS-GLI-02093-105-t1c.nii.gz,../../DataSet/BraTS2024-BraTS-GLI-TrainingData/BraTS-GLI-02093-105/BraTS-GLI-02093-105-t2w.nii.gz,../../DataSet/BraTS2024-BraTS-GLI-TrainingData/BraTS-GLI-02093-105/BraTS-GLI-02093-105-t2f.nii.gz,../../DataSet/BraTS2024-BraTS-GLI-TrainingData/BraTS-GLI-02093-105/BraTS-GLI-02093-105-t1n.nii.gz,../../DataSet/BraTS2024-BraTS-GLI-TrainingData/BraTS-GLI-02093-105/BraTS-GLI-02093-105-seg.nii.gz,108,172,91,68,138,116,202,52,139,70,86,87
02111-104,../../DataSet/BraTS2024-BraTS-GLI-TrainingData/BraTS-GLI-02111-104/BraTS-GLI-02111-104-t1c.nii.gz,../../DataSet/BraTS2024-BraTS-GLI-TrainingData/BraTS-GLI-02111-104/BraTS-GLI-02111-104-t2w.nii.gz,../../DataSet/BraTS2024-BraTS-GLI-TrainingData/BraTS-GLI-02111-104/BraTS-GLI-02111-104-t2f.nii.gz,../../DataSet/BraTS2024-BraTS-GLI-TrainingData/BraTS-GLI-02111-104/BraTS-GLI-02111-104-t1n.nii.gz,../../DataSet/BraTS2024-BraTS-GLI-TrainingData/BraTS-GLI-02111-104/BraTS-GLI-02111-104-seg.nii.gz,74,77,118,51,118,50,113,90,155,67,63,65
02060-101,../../DataSet/BraTS2024-BraTS-GLI-TrainingData/BraTS-GLI-02060-101/BraTS-GLI-02060-101-t1c.nii.gz,../../DataSet/BraTS2024-BraTS-GLI-TrainingData/BraTS-GLI-02060-101/BraTS-GLI-02060-101-t2w.nii.gz,../../DataSet/BraTS2024-BraTS-GLI-TrainingData/BraTS-GLI-02060-101/BraTS-GLI-02060-101-t2f.nii.gz,../../DataSet/BraTS2024-BraTS-GLI-TrainingData/BraTS-GLI-02060-101/BraTS-GLI-02060-101-t1n.nii.gz,../../DataSet/BraTS2024-BraTS-GLI-TrainingData/BraTS-GLI-02060-101/BraTS-GLI-02060-101-seg.nii.gz,129,72,78,99,158,33,125,52,120,59,92,68
03005-100,../../DataSet/BraTS2024-BraTS-GLI-TrainingData/BraTS-GLI-03005-100/BraTS-GLI-03005-100-t1c.nii.gz,../../DataSet/BraTS2024-BraTS-GLI-TrainingData/BraTS-GLI-03005-100/BraTS-GLI-03005-100-t2w.nii.gz,../../DataSet/BraTS2024-BraTS-GLI-TrainingData/BraTS-GLI-03005-100/BraTS-GLI-03005-100-t2f.nii.gz,../../DataSet/BraTS2024-BraTS-GLI-TrainingData/BraTS-GLI-03005-100/BraTS-GLI-03005-100-t1n.nii.gz,../../DataSet/BraTS2024-BraTS-GLI-TrainingData/BraTS-GLI-03005-100/BraTS-GLI-03005-100-seg.nii.gz,69,90,117,40,116,49,144,80,148,76,95,68
03009-101,../../DataSet/BraTS2024-BraTS-GLI-TrainingData/BraTS-GLI-03009-101/BraTS-GLI-03009-101-t1c.nii.gz,../../DataSet/BraTS2024-BraTS-GLI-TrainingData/BraTS-GLI-03009-101/BraTS-GLI-03009-101-t2w.nii.gz,../../DataSet/BraTS2024-BraTS-GLI-TrainingData/BraTS-GLI-03009-101/BraTS-GLI-03009-101-t2f.nii.gz,../../DataSet/BraTS2024-BraTS-GLI-TrainingData/BraTS-GLI-03009-101/BraTS-GLI-03009-101-t1n.nii.gz,../../DataSet/BraTS2024-BraTS-GLI-TrainingData/BraTS-GLI-03009-101/BraTS-GLI-03009-101-seg.nii.gz,63,50,73,40,84,21,95,48,113,44,74,65
02693-100,../../DataSet/BraTS2024-BraTS-GLI-TrainingData/BraTS-GLI-02693-100/BraTS-GLI-02693-100-t1c.nii.gz,../../DataSet/BraTS2024-BraTS-GLI-TrainingData/BraTS-GLI-02693-100/BraTS-GLI-02693-100-t2w.nii.gz,../../DataSet/BraTS2024-BraTS-GLI-TrainingData/BraTS-GLI-02693-100/BraTS-GLI-02693-100-t2f.nii.gz,../../DataSet/BraTS2024-BraTS-GLI-TrainingData/BraTS-GLI-02693-100/BraTS-GLI-02693-100-t1n.nii.gz,../../DataSet/BraTS2024-BraTS-GLI-TrainingData/BraTS-GLI-02693-100/BraTS-GLI-02693-100-seg.nii.gz,118,131,62,87,143,101,160,29,93,56,59,64
02223-100,../../DataSet/BraTS2024-BraTS-GLI-TrainingData/BraTS-GLI-02223-100/BraTS-GLI-02223-100-t1c.nii.gz,../../DataSet/BraTS2024-BraTS-GLI-TrainingData/BraTS-GLI-02223-100/BraTS-GLI-02223-100-t2w.nii.gz,../../DataSet/BraTS2024-BraTS-GLI-TrainingData/BraTS-GLI-02223-100/BraTS-GLI-02223-100-t2f.nii.gz,../../DataSet/BraTS2024-BraTS-GLI-TrainingData/BraTS-GLI-02223-100/BraTS-GLI-02223-100-t1n.nii.gz,../../DataSet/BraTS2024-BraTS-GLI-TrainingData/BraTS-GLI-02223-100/BraTS-GLI-02223-100-seg.nii.gz,52,66,90,30,78,45,101,67,116,48,56,49
02307-100,../../DataSet/BraTS2024-BraTS-GLI-TrainingData/BraTS-GLI-02307-100/BraTS-GLI-02307-100-t1c.nii.gz,../../DataSet/BraTS2024-BraTS-GLI-TrainingData/BraTS-GLI-02307-100/BraTS-GLI-02307-100-t2w.nii.gz,../../DataSet/BraTS2024-BraTS-GLI-TrainingData/BraTS-GLI-02307-100/BraTS-GLI-02307-100-t2f.nii.gz,../../DataSet/BraTS2024-BraTS-GLI-TrainingData/BraTS-GLI-02307-100/BraTS-GLI-02307-100-t1n.nii.gz,../../DataSet/BraTS2024-BraTS-GLI-TrainingData/BraTS-GLI-02307-100/BraTS-GLI-02307-100-seg.nii.gz,55,72,85,28,90,47,108,56,110,62,61,54
02498-102,../../DataSet/BraTS2024-BraTS-GLI-TrainingData/BraTS-GLI-02498-102/BraTS-GLI-02498-102-t1c.nii.gz,../../DataSet/BraTS2024-BraTS-GLI-TrainingData/BraTS-GLI-02498-102/BraTS-GLI-02498-102-t2w.nii.gz,../../DataSet/BraTS2024-BraTS-GLI-TrainingData/BraTS-GLI-02498-102/BraTS-GLI-02498-102-t2f.nii.gz,../../DataSet/BraTS2024-BraTS-GLI-TrainingData/BraTS-GLI-02498-102/BraTS-GLI-02498-102-t1n.nii.gz,../../DataSet/BraTS2024-BraTS-GLI-TrainingData/BraTS-GLI-02498-102/BraTS-GLI-02498-102-seg.nii.gz,105,126,112,65,136,90,161,78,152,71,71,74
02285-101,../../DataSet/BraTS2024-BraTS-GLI-TrainingData/BraTS-GLI-02285-101/BraTS-GLI-02285-101-t1c.nii.gz,../../DataSet/BraTS2024-BraTS-GLI-TrainingData/BraTS-GLI-02285-101/BraTS-GLI-02285-101-t2w.nii.gz,../../DataSet/BraTS2024-BraTS-GLI-TrainingData/BraTS-GLI-02285-101/BraTS-GLI-02285-101-t2f.nii.gz,../../DataSet/BraTS2024-BraTS-GLI-TrainingData/BraTS-GLI-02285-101/BraTS-GLI-02285-101-t1n.nii.gz,../../DataSet/BraTS2024-BraTS-GLI-TrainingData/BraTS-GLI-02285-101/BraTS-GLI-02285-101-seg.nii.gz,109,57,94,93,131,35,84,58,124,38,49,66
02192-101,../../DataSet/BraTS2024-BraTS-GLI-TrainingData/BraTS-GLI-02192-101/BraTS-GLI-02192-101-t1c.nii.gz,../../DataSet/BraTS2024-BraTS-GLI-TrainingData/BraTS-GLI-02192-101/BraTS-GLI-02192-101-t2w.nii.gz,../../DataSet/BraTS2024-BraTS-GLI-TrainingData/BraTS-GLI-02192-101/BraTS-GLI-02192-101-t2f.nii.gz,../../DataSet/BraTS2024-BraTS-GLI-TrainingData/BraTS-GLI-02192-101/BraTS-GLI-02192-101-t1n.nii.gz,../../DataSet/BraTS2024-BraTS-GLI-TrainingData/BraTS-GLI-02192-101/BraTS-GLI-02192-101-seg.nii.gz,117,60,90,70,146,23,99,55,125,76,76,70
02981-101,../../DataSet/BraTS2024-BraTS-GLI-TrainingData/BraTS-GLI-02981-101/BraTS-GLI-02981-101-t1c.nii.gz,../../DataSet/BraTS2024-BraTS-GLI-TrainingData/BraTS-GLI-02981-101/BraTS-GLI-02981-101-t2w.nii.gz,../../DataSet/BraTS2024-BraTS-GLI-TrainingData/BraTS-GLI-02981-101/BraTS-GLI-02981-101-t2f.nii.gz,../../DataSet/BraTS2024-BraTS-GLI-TrainingData/BraTS-GLI-02981-101/BraTS-GLI-02981-101-t1n.nii.gz,../../DataSet/BraTS2024-BraTS-GLI-TrainingData/BraTS-GLI-02981-101/BraTS-GLI-02981-101-seg.nii.gz,126,116,42,101,148,81,146,22,64,47,65,42
02803-100,../../DataSet/BraTS2024-BraTS-GLI-TrainingData/BraTS-GLI-02803-100/BraTS-GLI-02803-100-t1c.nii.gz,../../DataSet/BraTS2024-BraTS-GLI-TrainingData/BraTS-GLI-02803-100/BraTS-GLI-02803-100-t2w.nii.gz,../../DataSet/BraTS2024-BraTS-GLI-TrainingData/BraTS-GLI-02803-100/BraTS-GLI-02803-100-t2f.nii.gz,../../DataSet/BraTS2024-BraTS-GLI-TrainingData/BraTS-GLI-02803-100/BraTS-GLI-02803-100-t1n.nii.gz,../../DataSet/BraTS2024-BraTS-GLI-TrainingData/BraTS-GLI-02803-100/BraTS-GLI-02803-100-seg.nii.gz,46,80,77,26,80,42,123,51,107,54,81,56
02254-101,../../DataSet/BraTS2024-BraTS-GLI-TrainingData/BraTS-GLI-02254-101/BraTS-GLI-02254-101-t1c.nii.gz,../../DataSet/BraTS2024-BraTS-GLI-TrainingData/BraTS-GLI-02254-101/BraTS-GLI-02254-101-t2w.nii.gz,../../DataSet/BraTS2024-BraTS-GLI-TrainingData/BraTS-GLI-02254-101/BraTS-GLI-02254-101-t2f.nii.gz,../../DataSet/BraTS2024-BraTS-GLI-TrainingData/BraTS-GLI-02254-101/BraTS-GLI-02254-101-t1n.nii.gz,../../DataSet/BraTS2024-BraTS-GLI-TrainingData/BraTS-GLI-02254-101/BraTS-GLI-02254-101-seg.nii.gz,58,82,89,30,96,55,115,64,113,66,60,49
02170-102,../../DataSet/BraTS2024-BraTS-GLI-TrainingData/BraTS-GLI-02170-102/BraTS-GLI-02170-102-t1c.nii.gz,../../DataSet/BraTS2024-BraTS-GLI-TrainingData/BraTS-GLI-02170-102/BraTS-GLI-02170-102-t2w.nii.gz,../../DataSet/BraTS2024-BraTS-GLI-TrainingData/BraTS-GLI-02170-102/BraTS-GLI-02170-102-t2f.nii.gz,../../DataSet/BraTS2024-BraTS-GLI-TrainingData/BraTS-GLI-02170-102/BraTS-GLI-02170-102-t1n.nii.gz,../../DataSet/BraTS2024-BraTS-GLI-TrainingData/BraTS-GLI-02170-102/BraTS-GLI-02170-102-seg.nii.gz,58,88,105,31,87,51,128,65,150,56,77,85
02199-100,../../DataSet/BraTS2024-BraTS-GLI-TrainingData/BraTS-GLI-02199-100/BraTS-GLI-02199-100-t1c.nii.gz,../../DataSet/BraTS2024-BraTS-GLI-TrainingData/BraTS-GLI-02199-100/BraTS-GLI-02199-100-t2w.nii.gz,../../DataSet/BraTS2024-BraTS-GLI-TrainingData/BraTS-GLI-02199-100/BraTS-GLI-02199-100-t2f.nii.gz,../../DataSet/BraTS2024-BraTS-GLI-TrainingData/BraTS-GLI-02199-100/BraTS-GLI-02199-100-t1n.nii.gz,../../DataSet/BraTS2024-BraTS-GLI-TrainingData/BraTS-GLI-02199-100/BraTS-GLI-02199-100-seg.nii.gz,105,167,92,73,125,144,187,63,123,52,43,60
02786-100,../../DataSet/BraTS2024-BraTS-GLI-TrainingData/BraTS-GLI-02786-100/BraTS-GLI-02786-100-t1c.nii.gz,../../DataSet/BraTS2024-BraTS-GLI-TrainingData/BraTS-GLI-02786-100/BraTS-GLI-02786-100-t2w.nii.gz,../../DataSet/BraTS2024-BraTS-GLI-TrainingData/BraTS-GLI-02786-100/BraTS-GLI-02786-100-t2f.nii.gz,../../DataSet/BraTS2024-BraTS-GLI-TrainingData/BraTS-GLI-02786-100/BraTS-GLI-02786-100-t1n.nii.gz,../../DataSet/BraTS2024-BraTS-GLI-TrainingData/BraTS-GLI-02786-100/BraTS-GLI-02786-100-seg.nii.gz,50,115,56,27,78,69,151,31,83,51,82,52
00463-100,../../DataSet/BraTS2024-BraTS-GLI-TrainingData/BraTS-GLI-00463-100/BraTS-GLI-00463-100-t1c.nii.gz,../../DataSet/BraTS2024-BraTS-GLI-TrainingData/BraTS-GLI-00463-100/BraTS-GLI-00463-100-t2w.nii.gz,../../DataSet/BraTS2024-BraTS-GLI-TrainingData/BraTS-GLI-00463-100/BraTS-GLI-00463-100-t2f.nii.gz,../../DataSet/BraTS2024-BraTS-GLI-TrainingData/BraTS-GLI-00463-100/BraTS-GLI-00463-100-t1n.nii.gz,../../DataSet/BraTS2024-BraTS-GLI-TrainingData/BraTS-GLI-00463-100/BraTS-GLI-00463-100-seg.nii.gz,136,92,88,112,158,58,132,64,115,46,74,51
02336-100,../../DataSet/BraTS2024-BraTS-GLI-TrainingData/BraTS-GLI-02336-100/BraTS-GLI-02336-100-t1c.nii.gz,../../DataSet/BraTS2024-BraTS-GLI-TrainingData/BraTS-GLI-02336-100/BraTS-GLI-02336-100-t2w.nii.gz,../../DataSet/BraTS2024-BraTS-GLI-TrainingData/BraTS-GLI-02336-100/BraTS-GLI-02336-100-t2f.nii.gz,../../DataSet/BraTS2024-BraTS-GLI-TrainingData/BraTS-GLI-02336-100/BraTS-GLI-02336-100-t1n.nii.gz,../../DataSet/BraTS2024-BraTS-GLI-TrainingData/BraTS-GLI-02336-100/BraTS-GLI-02336-100-seg.nii.gz,109,149,112,89,133,115,180,62,149,44,65,87
02757-100,../../DataSet/BraTS2024-BraTS-GLI-TrainingData/BraTS-GLI-02757-100/BraTS-GLI-02757-100-t1c.nii.gz,../../DataSet/BraTS2024-BraTS-GLI-TrainingData/BraTS-GLI-02757-100/BraTS-GLI-02757-100-t2w.nii.gz,../../DataSet/BraTS2024-BraTS-GLI-TrainingData/BraTS-GLI-02757-100/BraTS-GLI-02757-100-t2f.nii.gz,../../DataSet/BraTS2024-BraTS-GLI-TrainingData/BraTS-GLI-02757-100/BraTS-GLI-02757-100-t1n.nii.gz,../../DataSet/BraTS2024-BraTS-GLI-TrainingData/BraTS-GLI-02757-100/BraTS-GLI-02757-100-seg.nii.gz,66,69,105,30,95,26,113,60,144,65,87,84
02839-101,../../DataSet/BraTS2024-BraTS-GLI-TrainingData/BraTS-GLI-02839-101/BraTS-GLI-02839-101-t1c.nii.gz,../../DataSet/BraTS2024-BraTS-GLI-TrainingData/BraTS-GLI-02839-101/BraTS-GLI-02839-101-t2w.nii.gz,../../DataSet/BraTS2024-BraTS-GLI-TrainingData/BraTS-GLI-02839-101/BraTS-GLI-02839-101-t2f.nii.gz,../../DataSet/BraTS2024-BraTS-GLI-TrainingData/BraTS-GLI-02839-101/BraTS-GLI-02839-101-t1n.nii.gz,../../DataSet/BraTS2024-BraTS-GLI-TrainingData/BraTS-GLI-02839-101/BraTS-GLI-02839-101-seg.nii.gz,120,108,124,103,145,93,123,106,146,42,30,40
02518-100,../../DataSet/BraTS2024-BraTS-GLI-TrainingData/BraTS-GLI-02518-100/BraTS-GLI-02518-100-t1c.nii.gz,../../DataSet/BraTS2024-BraTS-GLI-TrainingData/BraTS-GLI-02518-100/BraTS-GLI-02518-100-t2w.nii.gz,../../DataSet/BraTS2024-BraTS-GLI-TrainingData/BraTS-GLI-02518-100/BraTS-GLI-02518-100-t2f.nii.gz,../../DataSet/BraTS2024-BraTS-GLI-TrainingData/BraTS-GLI-02518-100/BraTS-GLI-02518-100-t1n.nii.gz,../../DataSet/BraTS2024-BraTS-GLI-TrainingData/BraTS-GLI-02518-100/BraTS-GLI-02518-100-seg.nii.gz,112,83,89,79,131,52,122,64,114,52,70,50
02219-101,../../DataSet/BraTS2024-BraTS-GLI-TrainingData/BraTS-GLI-02219-101/BraTS-GLI-02219-101-t1c.nii.gz,../../DataSet/BraTS2024-BraTS-GLI-TrainingData/BraTS-GLI-02219-101/BraTS-GLI-02219-101-t2w.nii.gz,../../DataSet/BraTS2024-BraTS-GLI-TrainingData/BraTS-GLI-02219-101/BraTS-GLI-02219-101-t2f.nii.gz,../../DataSet/BraTS2024-BraTS-GLI-TrainingData/BraTS-GLI-02219-101/BraTS-GLI-02219-101-t1n.nii.gz,../../DataSet/BraTS2024-BraTS-GLI-TrainingData/BraTS-GLI-02219-101/BraTS-GLI-02219-101-seg.nii.gz,55,118,117,37,71,98,136,99,141,34,38,42
02136-103,../../DataSet/BraTS2024-BraTS-GLI-TrainingData/BraTS-GLI-02136-103/BraTS-GLI-02136-103-t1c.nii.gz,../../DataSet/BraTS2024-BraTS-GLI-TrainingData/BraTS-GLI-02136-103/BraTS-GLI-02136-103-t2w.nii.gz,../../DataSet/BraTS2024-BraTS-GLI-TrainingData/BraTS-GLI-02136-103/BraTS-GLI-02136-103-t2f.nii.gz,../../DataSet/BraTS2024-BraTS-GLI-TrainingData/BraTS-GLI-02136-103/BraTS-GLI-02136-103-t1n.nii.gz,../../DataSet/BraTS2024-BraTS-GLI-TrainingData/BraTS-GLI-02136-103/BraTS-GLI-02136-103-seg.nii.gz,59,129,104,34,87,104,153,72,148,53,49,76
02390-101,../../DataSet/BraTS2024-BraTS-GLI-TrainingData/BraTS-GLI-02390-101/BraTS-GLI-02390-101-t1c.nii.gz,../../DataSet/BraTS2024-BraTS-GLI-TrainingData/BraTS-GLI-02390-101/BraTS-GLI-02390-101-t2w.nii.gz,../../DataSet/BraTS2024-BraTS-GLI-TrainingData/BraTS-GLI-02390-101/BraTS-GLI-02390-101-t2f.nii.gz,../../DataSet/BraTS2024-BraTS-GLI-TrainingData/BraTS-GLI-02390-101/BraTS-GLI-02390-101-t1n.nii.gz,../../DataSet/BraTS2024-BraTS-GLI-TrainingData/BraTS-GLI-02390-101/BraTS-GLI-02390-101-seg.nii.gz,54,73,98,33,80,56,114,72,118,47,58,46
02845-101,../../DataSet/BraTS2024-BraTS-GLI-TrainingData/BraTS-GLI-02845-101/BraTS-GLI-02845-101-t1c.nii.gz,../../DataSet/BraTS2024-BraTS-GLI-TrainingData/BraTS-GLI-02845-101/BraTS-GLI-02845-101-t2w.nii.gz,../../DataSet/BraTS2024-BraTS-GLI-TrainingData/BraTS-GLI-02845-101/BraTS-GLI-02845-101-t2f.nii.gz,../../DataSet/BraTS2024-BraTS-GLI-TrainingData/BraTS-GLI-02845-101/BraTS-GLI-02845-101-t1n.nii.gz,../../DataSet/BraTS2024-BraTS-GLI-TrainingData/BraTS-GLI-02845-101/BraTS-GLI-02845-101-seg.nii.gz,111,93,105,98,134,61,128,88,130,36,67,42
02105-100,../../DataSet/BraTS2024-BraTS-GLI-TrainingData/BraTS-GLI-02105-100/BraTS-GLI-02105-100-t1c.nii.gz,../../DataSet/BraTS2024-BraTS-GLI-TrainingData/BraTS-GLI-02105-100/BraTS-GLI-02105-100-t2w.nii.gz,../../DataSet/BraTS2024-BraTS-GLI-TrainingData/BraTS-GLI-02105-100/BraTS-GLI-02105-100-t2f.nii.gz,../../DataSet/BraTS2024-BraTS-GLI-TrainingData/BraTS-GLI-02105-100/BraTS-GLI-02105-100-t1n.nii.gz,../../DataSet/BraTS2024-BraTS-GLI-TrainingData/BraTS-GLI-02105-100/BraTS-GLI-02105-100-seg.nii.gz,78,75,128,60,91,57,103,110,148,31,46,38
02916-100,../../DataSet/BraTS2024-BraTS-GLI-TrainingData/BraTS-GLI-02916-100/BraTS-GLI-02916-100-t1c.nii.gz,../../DataSet/BraTS2024-BraTS-GLI-TrainingData/BraTS-GLI-02916-100/BraTS-GLI-02916-100-t2w.nii.gz,../../DataSet/BraTS2024-BraTS-GLI-TrainingData/BraTS-GLI-02916-100/BraTS-GLI-02916-100-t2f.nii.gz,../../DataSet/BraTS2024-BraTS-GLI-TrainingData/BraTS-GLI-02916-100/BraTS-GLI-02916-100-t1n.nii.gz,../../DataSet/BraTS2024-BraTS-GLI-TrainingData/BraTS-GLI-02916-100/BraTS-GLI-02916-100-seg.nii.gz,67,146,120,42,110,106,176,80,146,68,70,66
02894-101,../../DataSet/BraTS2024-BraTS-GLI-TrainingData/BraTS-GLI-02894-101/BraTS-GLI-02894-101-t1c.nii.gz,../../DataSet/BraTS2024-BraTS-GLI-TrainingData/BraTS-GLI-02894-101/BraTS-GLI-02894-101-t2w.nii.gz,../../DataSet/BraTS2024-BraTS-GLI-TrainingData/BraTS-GLI-02894-101/BraTS-GLI-02894-101-t2f.nii.gz,../../DataSet/BraTS2024-BraTS-GLI-TrainingData/BraTS-GLI-02894-101/BraTS-GLI-02894-101-t1n.nii.gz,../../DataSet/BraTS2024-BraTS-GLI-TrainingData/BraTS-GLI-02894-101/BraTS-GLI-02894-101-seg.nii.gz,116,115,121,94,141,80,155,92,147,47,75,55
02062-102,../../DataSet/BraTS2024-BraTS-GLI-TrainingData/BraTS-GLI-02062-102/BraTS-GLI-02062-102-t1c.nii.gz,../../DataSet/BraTS2024-BraTS-GLI-TrainingData/BraTS-GLI-02062-102/BraTS-GLI-02062-102-t2w.nii.gz,../../DataSet/BraTS2024-BraTS-GLI-TrainingData/BraTS-GLI-02062-102/BraTS-GLI-02062-102-t2f.nii.gz,../../DataSet/BraTS2024-BraTS-GLI-TrainingData/BraTS-GLI-02062-102/BraTS-GLI-02062-102-t1n.nii.gz,../../DataSet/BraTS2024-BraTS-GLI-TrainingData/BraTS-GLI-02062-102/BraTS-GLI-02062-102-seg.nii.gz,53,92,101,31,79,46,132,63,132,48,86,69
02131-103,../../DataSet/BraTS2024-BraTS-GLI-TrainingData/BraTS-GLI-02131-103/BraTS-GLI-02131-103-t1c.nii.gz,../../DataSet/BraTS2024-BraTS-GLI-TrainingData/BraTS-GLI-02131-103/BraTS-GLI-02131-103-t2w.nii.gz,../../DataSet/BraTS2024-BraTS-GLI-TrainingData/BraTS-GLI-02131-103/BraTS-GLI-02131-103-t2f.nii.gz,../../DataSet/BraTS2024-BraTS-GLI-TrainingData/BraTS-GLI-02131-103/BraTS-GLI-02131-103-t1n.nii.gz,../../DataSet/BraTS2024-BraTS-GLI-TrainingData/BraTS-GLI-02131-103/BraTS-GLI-02131-103-seg.nii.gz,48,104,67,30,79,76,130,50,86,49,54,36
02215-100,../../DataSet/BraTS2024-BraTS-GLI-TrainingData/BraTS-GLI-02215-100/BraTS-GLI-02215-100-t1c.nii.gz,../../DataSet/BraTS2024-BraTS-GLI-TrainingData/BraTS-GLI-02215-100/BraTS-GLI-02215-100-t2w.nii.gz,../../DataSet/BraTS2024-BraTS-GLI-TrainingData/BraTS-GLI-02215-100/BraTS-GLI-02215-100-t2f.nii.gz,../../DataSet/BraTS2024-BraTS-GLI-TrainingData/BraTS-GLI-02215-100/BraTS-GLI-02215-100-t1n.nii.gz,../../DataSet/BraTS2024-BraTS-GLI-TrainingData/BraTS-GLI-02215-100/BraTS-GLI-02215-100-seg.nii.gz,142,88,111,120,156,73,106,92,134,36,33,42
02893-101,../../DataSet/BraTS2024-BraTS-GLI-TrainingData/BraTS-GLI-02893-101/BraTS-GLI-02893-101-t1c.nii.gz,../../DataSet/BraTS2024-BraTS-GLI-TrainingData/BraTS-GLI-02893-101/BraTS-GLI-02893-101-t2w.nii.gz,../../DataSet/BraTS2024-BraTS-GLI-TrainingData/BraTS-GLI-02893-101/BraTS-GLI-02893-101-t2f.nii.gz,../../DataSet/BraTS2024-BraTS-GLI-TrainingData/BraTS-GLI-02893-101/BraTS-GLI-02893-101-t1n.nii.gz,../../DataSet/BraTS2024-BraTS-GLI-TrainingData/BraTS-GLI-02893-101/BraTS-GLI-02893-101-seg.nii.gz,125,92,112,101,154,56,127,81,137,53,71,56
02911-100,../../DataSet/BraTS2024-BraTS-GLI-TrainingData/BraTS-GLI-02911-100/BraTS-GLI-02911-100-t1c.nii.gz,../../DataSet/BraTS2024-BraTS-GLI-TrainingData/BraTS-GLI-02911-100/BraTS-GLI-02911-100-t2w.nii.gz,../../DataSet/BraTS2024-BraTS-GLI-TrainingData/BraTS-GLI-02911-100/BraTS-GLI-02911-100-t2f.nii.gz,../../DataSet/BraTS2024-BraTS-GLI-TrainingData/BraTS-GLI-02911-100/BraTS-GLI-02911-100-t1n.nii.gz,../../DataSet/BraTS2024-BraTS-GLI-TrainingData/BraTS-GLI-02911-100/BraTS-GLI-02911-100-seg.nii.gz,127,59,95,103,149,26,96,66,123,46,70,57
02781-100,../../DataSet/BraTS2024-BraTS-GLI-TrainingData/BraTS-GLI-02781-100/BraTS-GLI-02781-100-t1c.nii.gz,../../DataSet/BraTS2024-BraTS-GLI-TrainingData/BraTS-GLI-02781-100/BraTS-GLI-02781-100-t2w.nii.gz,../../DataSet/BraTS2024-BraTS-GLI-TrainingData/BraTS-GLI-02781-100/BraTS-GLI-02781-100-t2f.nii.gz,../../DataSet/BraTS2024-BraTS-GLI-TrainingData/BraTS-GLI-02781-100/BraTS-GLI-02781-100-t1n.nii.gz,../../DataSet/BraTS2024-BraTS-GLI-TrainingData/BraTS-GLI-02781-100/BraTS-GLI-02781-100-seg.nii.gz,64,102,124,43,82,55,150,98,152,39,95,54
02835-100,../../DataSet/BraTS2024-BraTS-GLI-TrainingData/BraTS-GLI-02835-100/BraTS-GLI-02835-100-t1c.nii.gz,../../DataSet/BraTS2024-BraTS-GLI-TrainingData/BraTS-GLI-02835-100/BraTS-GLI-02835-100-t2w.nii.gz,../../DataSet/BraTS2024-BraTS-GLI-TrainingData/BraTS-GLI-02835-100/BraTS-GLI-02835-100-t2f.nii.gz,../../DataSet/BraTS2024-BraTS-GLI-TrainingData/BraTS-GLI-02835-100/BraTS-GLI-02835-100-t1n.nii.gz,../../DataSet/BraTS2024-BraTS-GLI-TrainingData/BraTS-GLI-02835-100/BraTS-GLI-02835-100-seg.nii.gz,51,98,115,33,79,73,131,95,143,46,58,48
02331-100,../../DataSet/BraTS2024-BraTS-GLI-TrainingData/BraTS-GLI-02331-100/BraTS-GLI-02331-100-t1c.nii.gz,../../DataSet/BraTS2024-BraTS-GLI-TrainingData/BraTS-GLI-02331-100/BraTS-GLI-02331-100-t2w.nii.gz,../../DataSet/BraTS2024-BraTS-GLI-TrainingData/BraTS-GLI-02331-100/BraTS-GLI-02331-100-t2f.nii.gz,../../DataSet/BraTS2024-BraTS-GLI-TrainingData/BraTS-GLI-02331-100/BraTS-GLI-02331-100-t1n.nii.gz,../../DataSet/BraTS2024-BraTS-GLI-TrainingData/BraTS-GLI-02331-100/BraTS-GLI-02331-100-seg.nii.gz,99,92,35,74,121,75,127,18,60,47,52,42
00005-100,../../DataSet/BraTS2024-BraTS-GLI-TrainingData/BraTS-GLI-00005-100/BraTS-GLI-00005-100-t1c.nii.gz,../../DataSet/BraTS2024-BraTS-GLI-TrainingData/BraTS-GLI-00005-100/BraTS-GLI-00005-100-t2w.nii.gz,../../DataSet/BraTS2024-BraTS-GLI-TrainingData/BraTS-GLI-00005-100/BraTS-GLI-00005-100-t2f.nii.gz,../../DataSet/BraTS2024-BraTS-GLI-TrainingData/BraTS-GLI-00005-100/BraTS-GLI-00005-100-t1n.nii.gz,../../DataSet/BraTS2024-BraTS-GLI-TrainingData/BraTS-GLI-00005-100/BraTS-GLI-00005-100-seg.nii.gz,110,60,124,92,132,34,85,103,151,40,51,48
02175-101,../../DataSet/BraTS2024-BraTS-GLI-TrainingData/BraTS-GLI-02175-101/BraTS-GLI-02175-101-t1c.nii.gz,../../DataSet/BraTS2024-BraTS-GLI-TrainingData/BraTS-GLI-02175-101/BraTS-GLI-02175-101-t2w.nii.gz,../../DataSet/BraTS2024-BraTS-GLI-TrainingData/BraTS-GLI-02175-101/BraTS-GLI-02175-101-t2f.nii.gz,../../DataSet/BraTS2024-BraTS-GLI-TrainingData/BraTS-GLI-02175-101/BraTS-GLI-02175-101-t1n.nii.gz,../../DataSet/BraTS2024-BraTS-GLI-TrainingData/BraTS-GLI-02175-101/BraTS-GLI-02175-101-seg.nii.gz,130,78,86,106,156,44,116,54,123,50,72,69
02750-100,../../DataSet/BraTS2024-BraTS-GLI-TrainingData/BraTS-GLI-02750-100/BraTS-GLI-02750-100-t1c.nii.gz,../../DataSet/BraTS2024-BraTS-GLI-TrainingData/BraTS-GLI-02750-100/BraTS-GLI-02750-100-t2w.nii.gz,../../DataSet/BraTS2024-BraTS-GLI-TrainingData/BraTS-GLI-02750-100/BraTS-GLI-02750-100-t2f.nii.gz,../../DataSet/BraTS2024-BraTS-GLI-TrainingData/BraTS-GLI-02750-100/BraTS-GLI-02750-100-t1n.nii.gz,../../DataSet/BraTS2024-BraTS-GLI-TrainingData/BraTS-GLI-02750-100/BraTS-GLI-02750-100-seg.nii.gz,124,63,40,102,140,46,84,27,52,38,38,25
02608-100,../../DataSet/BraTS2024-BraTS-GLI-TrainingData/BraTS-GLI-02608-100/BraTS-GLI-02608-100-t1c.nii.gz,../../DataSet/BraTS2024-BraTS-GLI-TrainingData/BraTS-GLI-02608-100/BraTS-GLI-02608-100-t2w.nii.gz,../../DataSet/BraTS2024-BraTS-GLI-TrainingData/BraTS-GLI-02608-100/BraTS-GLI-02608-100-t2f.nii.gz,../../DataSet/BraTS2024-BraTS-GLI-TrainingData/BraTS-GLI-02608-100/BraTS-GLI-02608-100-t1n.nii.gz,../../DataSet/BraTS2024-BraTS-GLI-TrainingData/BraTS-GLI-02608-100/BraTS-GLI-02608-100-seg.nii.gz,118,68,98,66,155,28,107,57,144,89,79,87
02146-102,../../DataSet/BraTS2024-BraTS-GLI-TrainingData/BraTS-GLI-02146-102/BraTS-GLI-02146-102-t1c.nii.gz,../../DataSet/BraTS2024-BraTS-GLI-TrainingData/BraTS-GLI-02146-102/BraTS-GLI-02146-102-t2w.nii.gz,../../DataSet/BraTS2024-BraTS-GLI-TrainingData/BraTS-GLI-02146-102/BraTS-GLI-02146-102-t2f.nii.gz,../../DataSet/BraTS2024-BraTS-GLI-TrainingData/BraTS-GLI-02146-102/BraTS-GLI-02146-102-t1n.nii.gz,../../DataSet/BraTS2024-BraTS-GLI-TrainingData/BraTS-GLI-02146-102/BraTS-GLI-02146-102-seg.nii.gz,127,66,76,108,142,41,93,54,104,34,52,50
03031-101,../../DataSet/BraTS2024-BraTS-GLI-TrainingData/BraTS-GLI-03031-101/BraTS-GLI-03031-101-t1c.nii.gz,../../DataSet/BraTS2024-BraTS-GLI-TrainingData/BraTS-GLI-03031-101/BraTS-GLI-03031-101-t2w.nii.gz,../../DataSet/BraTS2024-BraTS-GLI-TrainingData/BraTS-GLI-03031-101/BraTS-GLI-03031-101-t2f.nii.gz,../../DataSet/BraTS2024-BraTS-GLI-TrainingData/BraTS-GLI-03031-101/BraTS-GLI-03031-101-t1n.nii.gz,../../DataSet/BraTS2024-BraTS-GLI-TrainingData/BraTS-GLI-03031-101/BraTS-GLI-03031-101-seg.nii.gz,50,129,77,27,69,99,158,45,105,42,59,60
02914-101,../../DataSet/BraTS2024-BraTS-GLI-TrainingData/BraTS-GLI-02914-101/BraTS-GLI-02914-101-t1c.nii.gz,../../DataSet/BraTS2024-BraTS-GLI-TrainingData/BraTS-GLI-02914-101/BraTS-GLI-02914-101-t2w.nii.gz,../../DataSet/BraTS2024-BraTS-GLI-TrainingData/BraTS-GLI-02914-101/BraTS-GLI-02914-101-t2f.nii.gz,../../DataSet/BraTS2024-BraTS-GLI-TrainingData/BraTS-GLI-02914-101/BraTS-GLI-02914-101-t1n.nii.gz,../../DataSet/BraTS2024-BraTS-GLI-TrainingData/BraTS-GLI-02914-101/BraTS-GLI-02914-101-seg.nii.gz,96,96,88,55,143,46,135,62,126,88,89,64
02722-100,../../DataSet/BraTS2024-BraTS-GLI-TrainingData/BraTS-GLI-02722-100/BraTS-GLI-02722-100-t1c.nii.gz,../../DataSet/BraTS2024-BraTS-GLI-TrainingData/BraTS-GLI-02722-100/BraTS-GLI-02722-100-t2w.nii.gz,../../DataSet/BraTS2024-BraTS-GLI-TrainingData/BraTS-GLI-02722-100/BraTS-GLI-02722-100-t2f.nii.gz,../../DataSet/BraTS2024-BraTS-GLI-TrainingData/BraTS-GLI-02722-100/BraTS-GLI-02722-100-t1n.nii.gz,../../DataSet/BraTS2024-BraTS-GLI-TrainingData/BraTS-GLI-02722-100/BraTS-GLI-02722-100-seg.nii.gz,109,68,88,92,132,41,107,63,107,40,66,44
02498-100,../../DataSet/BraTS2024-BraTS-GLI-TrainingData/BraTS-GLI-02498-100/BraTS-GLI-02498-100-t1c.nii.gz,../../DataSet/BraTS2024-BraTS-GLI-TrainingData/BraTS-GLI-02498-100/BraTS-GLI-02498-100-t2w.nii.gz,../../DataSet/BraTS2024-BraTS-GLI-TrainingData/BraTS-GLI-02498-100/BraTS-GLI-02498-100-t2f.nii.gz,../../DataSet/BraTS2024-BraTS-GLI-TrainingData/BraTS-GLI-02498-100/BraTS-GLI-02498-100-t1n.nii.gz,../../DataSet/BraTS2024-BraTS-GLI-TrainingData/BraTS-GLI-02498-100/BraTS-GLI-02498-100-seg.nii.gz,107,118,124,92,128,92,148,94,153,36,56,59
02285-103,../../DataSet/BraTS2024-BraTS-GLI-TrainingData/BraTS-GLI-02285-103/BraTS-GLI-02285-103-t1c.nii.gz,../../DataSet/BraTS2024-BraTS-GLI-TrainingData/BraTS-GLI-02285-103/BraTS-GLI-02285-103-t2w.nii.gz,../../DataSet/BraTS2024-BraTS-GLI-TrainingData/BraTS-GLI-02285-103/BraTS-GLI-02285-103-t2f.nii.gz,../../DataSet/BraTS2024-BraTS-GLI-TrainingData/BraTS-GLI-02285-103/BraTS-GLI-02285-103-t1n.nii.gz,../../DataSet/BraTS2024-BraTS-GLI-TrainingData/BraTS-GLI-02285-103/BraTS-GLI-02285-103-seg.nii.gz,110,63,95,69,139,35,97,55,133,70,62,78
02968-101,../../DataSet/BraTS2024-BraTS-GLI-TrainingData/BraTS-GLI-02968-101/BraTS-GLI-02968-101-t1c.nii.gz,../../DataSet/BraTS2024-BraTS-GLI-TrainingData/BraTS-GLI-02968-101/BraTS-GLI-02968-101-t2w.nii.gz,../../DataSet/BraTS2024-BraTS-GLI-TrainingData/BraTS-GLI-02968-101/BraTS-GLI-02968-101-t2f.nii.gz,../../DataSet/BraTS2024-BraTS-GLI-TrainingData/BraTS-GLI-02968-101/BraTS-GLI-02968-101-t1n.nii.gz,../../DataSet/BraTS2024-BraTS-GLI-TrainingData/BraTS-GLI-02968-101/BraTS-GLI-02968-101-seg.nii.gz,63,157,92,44,94,103,180,70,112,50,77,42
02152-104,../../DataSet/BraTS2024-BraTS-GLI-TrainingData/BraTS-GLI-02152-104/BraTS-GLI-02152-104-t1c.nii.gz,../../DataSet/BraTS2024-BraTS-GLI-TrainingData/BraTS-GLI-02152-104/BraTS-GLI-02152-104-t2w.nii.gz,../../DataSet/BraTS2024-BraTS-GLI-TrainingData/BraTS-GLI-02152-104/BraTS-GLI-02152-104-t2f.nii.gz,../../DataSet/BraTS2024-BraTS-GLI-TrainingData/BraTS-GLI-02152-104/BraTS-GLI-02152-104-t1n.nii.gz,../../DataSet/BraTS2024-BraTS-GLI-TrainingData/BraTS-GLI-02152-104/BraTS-GLI-02152-104-seg.nii.gz,60,79,91,41,86,43,125,46,122,45,82,76
02267-100,../../DataSet/BraTS2024-BraTS-GLI-TrainingData/BraTS-GLI-02267-100/BraTS-GLI-02267-100-t1c.nii.gz,../../DataSet/BraTS2024-BraTS-GLI-TrainingData/BraTS-GLI-02267-100/BraTS-GLI-02267-100-t2w.nii.gz,../../DataSet/BraTS2024-BraTS-GLI-TrainingData/BraTS-GLI-02267-100/BraTS-GLI-02267-100-t2f.nii.gz,../../DataSet/BraTS2024-BraTS-GLI-TrainingData/BraTS-GLI-02267-100/BraTS-GLI-02267-100-t1n.nii.gz,../../DataSet/BraTS2024-BraTS-GLI-TrainingData/BraTS-GLI-02267-100/BraTS-GLI-02267-100-seg.nii.gz,115,123,113,82,149,79,174,62,157,67,95,95
02830-101,../../DataSet/BraTS2024-BraTS-GLI-TrainingData/BraTS-GLI-02830-101/BraTS-GLI-02830-101-t1c.nii.gz,../../DataSet/BraTS2024-BraTS-GLI-TrainingData/BraTS-GLI-02830-101/BraTS-GLI-02830-101-t2w.nii.gz,../../DataSet/BraTS2024-BraTS-GLI-TrainingData/BraTS-GLI-02830-101/BraTS-GLI-02830-101-t2f.nii.gz,../../DataSet/BraTS2024-BraTS-GLI-TrainingData/BraTS-GLI-02830-101/BraTS-GLI-02830-101-t1n.nii.gz,../../DataSet/BraTS2024-BraTS-GLI-TrainingData/BraTS-GLI-02830-101/BraTS-GLI-02830-101-seg.nii.gz,70,146,122,47,88,108,191,92,151,41,83,59
02199-102,../../DataSet/BraTS2024-BraTS-GLI-TrainingData/BraTS-GLI-02199-102/BraTS-GLI-02199-102-t1c.nii.gz,../../DataSet/BraTS2024-BraTS-GLI-TrainingData/BraTS-GLI-02199-102/BraTS-GLI-02199-102-t2w.nii.gz,../../DataSet/BraTS2024-BraTS-GLI-TrainingData/BraTS-GLI-02199-102/BraTS-GLI-02199-102-t2f.nii.gz,../../DataSet/BraTS2024-BraTS-GLI-TrainingData/BraTS-GLI-02199-102/BraTS-GLI-02199-102-t1n.nii.gz,../../DataSet/BraTS2024-BraTS-GLI-TrainingData/BraTS-GLI-02199-102/BraTS-GLI-02199-102-seg.nii.gz,104,161,98,73,125,106,186,70,135,52,80,65
02755-101,../../DataSet/BraTS2024-BraTS-GLI-TrainingData/BraTS-GLI-02755-101/BraTS-GLI-02755-101-t1c.nii.gz,../../DataSet/BraTS2024-BraTS-GLI-TrainingData/BraTS-GLI-02755-101/BraTS-GLI-02755-101-t2w.nii.gz,../../DataSet/BraTS2024-BraTS-GLI-TrainingData/BraTS-GLI-02755-101/BraTS-GLI-02755-101-t2f.nii.gz,../../DataSet/BraTS2024-BraTS-GLI-TrainingData/BraTS-GLI-02755-101/BraTS-GLI-02755-101-t1n.nii.gz,../../DataSet/BraTS2024-BraTS-GLI-TrainingData/BraTS-GLI-02755-101/BraTS-GLI-02755-101-seg.nii.gz,67,130,130,45,85,89,175,99,155,40,86,56
02170-100,../../DataSet/BraTS2024-BraTS-GLI-TrainingData/BraTS-GLI-02170-100/BraTS-GLI-02170-100-t1c.nii.gz,../../DataSet/BraTS2024-BraTS-GLI-TrainingData/BraTS-GLI-02170-100/BraTS-GLI-02170-100-t2w.nii.gz,../../DataSet/BraTS2024-BraTS-GLI-TrainingData/BraTS-GLI-02170-100/BraTS-GLI-02170-100-t2f.nii.gz,../../DataSet/BraTS2024-BraTS-GLI-TrainingData/BraTS-GLI-02170-100/BraTS-GLI-02170-100-t1n.nii.gz,../../DataSet/BraTS2024-BraTS-GLI-TrainingData/BraTS-GLI-02170-100/BraTS-GLI-02170-100-seg.nii.gz,47,81,91,33,64,69,98,73,115,31,29,42
02632-103,../../DataSet/BraTS2024-BraTS-GLI-TrainingData/BraTS-GLI-02632-103/BraTS-GLI-02632-103-t1c.nii.gz,../../DataSet/BraTS2024-BraTS-GLI-TrainingData/BraTS-GLI-02632-103/BraTS-GLI-02632-103-t2w.nii.gz,../../DataSet/BraTS2024-BraTS-GLI-TrainingData/BraTS-GLI-02632-103/BraTS-GLI-02632-103-t2f.nii.gz,../../DataSet/BraTS2024-BraTS-GLI-TrainingData/BraTS-GLI-02632-103/BraTS-GLI-02632-103-t1n.nii.gz,../../DataSet/BraTS2024-BraTS-GLI-TrainingData/BraTS-GLI-02632-103/BraTS-GLI-02632-103-seg.nii.gz,120,68,97,92,152,33,106,69,129,60,73,60
02788-100,../../DataSet/BraTS2024-BraTS-GLI-TrainingData/BraTS-GLI-02788-100/BraTS-GLI-02788-100-t1c.nii.gz,../../DataSet/BraTS2024-BraTS-GLI-TrainingData/BraTS-GLI-02788-100/BraTS-GLI-02788-100-t2w.nii.gz,../../DataSet/BraTS2024-BraTS-GLI-TrainingData/BraTS-GLI-02788-100/BraTS-GLI-02788-100-t2f.nii.gz,../../DataSet/BraTS2024-BraTS-GLI-TrainingData/BraTS-GLI-02788-100/BraTS-GLI-02788-100-t1n.nii.gz,../../DataSet/BraTS2024-BraTS-GLI-TrainingData/BraTS-GLI-02788-100/BraTS-GLI-02788-100-seg.nii.gz,45,80,106,24,73,64,102,87,128,49,38,41
02300-102,../../DataSet/BraTS2024-BraTS-GLI-TrainingData/BraTS-GLI-02300-102/BraTS-GLI-02300-102-t1c.nii.gz,../../DataSet/BraTS2024-BraTS-GLI-TrainingData/BraTS-GLI-02300-102/BraTS-GLI-02300-102-t2w.nii.gz,../../DataSet/BraTS2024-BraTS-GLI-TrainingData/BraTS-GLI-02300-102/BraTS-GLI-02300-102-t2f.nii.gz,../../DataSet/BraTS2024-BraTS-GLI-TrainingData/BraTS-GLI-02300-102/BraTS-GLI-02300-102-t1n.nii.gz,../../DataSet/BraTS2024-BraTS-GLI-TrainingData/BraTS-GLI-02300-102/BraTS-GLI-02300-102-seg.nii.gz,99,146,122,60,129,93,184,83,150,69,91,67
02837-101,../../DataSet/BraTS2024-BraTS-GLI-TrainingData/BraTS-GLI-02837-101/BraTS-GLI-02837-101-t1c.nii.gz,../../DataSet/BraTS2024-BraTS-GLI-TrainingData/BraTS-GLI-02837-101/BraTS-GLI-02837-101-t2w.nii.gz,../../DataSet/BraTS2024-BraTS-GLI-TrainingData/BraTS-GLI-02837-101/BraTS-GLI-02837-101-t2f.nii.gz,../../DataSet/BraTS2024-BraTS-GLI-TrainingData/BraTS-GLI-02837-101/BraTS-GLI-02837-101-t1n.nii.gz,../../DataSet/BraTS2024-BraTS-GLI-TrainingData/BraTS-GLI-02837-101/BraTS-GLI-02837-101-seg.nii.gz,70,77,94,51,90,49,100,58,118,39,51,60
02752-101,../../DataSet/BraTS2024-BraTS-GLI-TrainingData/BraTS-GLI-02752-101/BraTS-GLI-02752-101-t1c.nii.gz,../../DataSet/BraTS2024-BraTS-GLI-TrainingData/BraTS-GLI-02752-101/BraTS-GLI-02752-101-t2w.nii.gz,../../DataSet/BraTS2024-BraTS-GLI-TrainingData/BraTS-GLI-02752-101/BraTS-GLI-02752-101-t2f.nii.gz,../../DataSet/BraTS2024-BraTS-GLI-TrainingData/BraTS-GLI-02752-101/BraTS-GLI-02752-101-t1n.nii.gz,../../DataSet/BraTS2024-BraTS-GLI-TrainingData/BraTS-GLI-02752-101/BraTS-GLI-02752-101-seg.nii.gz,68,164,93,45,89,135,191,69,126,44,56,57
02289-102,../../DataSet/BraTS2024-BraTS-GLI-TrainingData/BraTS-GLI-02289-102/BraTS-GLI-02289-102-t1c.nii.gz,../../DataSet/BraTS2024-BraTS-GLI-TrainingData/BraTS-GLI-02289-102/BraTS-GLI-02289-102-t2w.nii.gz,../../DataSet/BraTS2024-BraTS-GLI-TrainingData/BraTS-GLI-02289-102/BraTS-GLI-02289-102-t2f.nii.gz,../../DataSet/BraTS2024-BraTS-GLI-TrainingData/BraTS-GLI-02289-102/BraTS-GLI-02289-102-t1n.nii.gz,../../DataSet/BraTS2024-BraTS-GLI-TrainingData/BraTS-GLI-02289-102/BraTS-GLI-02289-102-seg.nii.gz,116,131,103,87,142,78,170,64,132,55,92,68
02217-101,../../DataSet/BraTS2024-BraTS-GLI-TrainingData/BraTS-GLI-02217-101/BraTS-GLI-02217-101-t1c.nii.gz,../../DataSet/BraTS2024-BraTS-GLI-TrainingData/BraTS-GLI-02217-101/BraTS-GLI-02217-101-t2w.nii.gz,../../DataSet/BraTS2024-BraTS-GLI-TrainingData/BraTS-GLI-02217-101/BraTS-GLI-02217-101-t2f.nii.gz,../../DataSet/BraTS2024-BraTS-GLI-TrainingData/BraTS-GLI-02217-101/BraTS-GLI-02217-101-t1n.nii.gz,../../DataSet/BraTS2024-BraTS-GLI-TrainingData/BraTS-GLI-02217-101/BraTS-GLI-02217-101-seg.nii.gz,129,122,89,114,147,104,140,70,105,33,36,35
02891-100,../../DataSet/BraTS2024-BraTS-GLI-TrainingData/BraTS-GLI-02891-100/BraTS-GLI-02891-100-t1c.nii.gz,../../DataSet/BraTS2024-BraTS-GLI-TrainingData/BraTS-GLI-02891-100/BraTS-GLI-02891-100-t2w.nii.gz,../../DataSet/BraTS2024-BraTS-GLI-TrainingData/BraTS-GLI-02891-100/BraTS-GLI-02891-100-t2f.nii.gz,../../DataSet/BraTS2024-BraTS-GLI-TrainingData/BraTS-GLI-02891-100/BraTS-GLI-02891-100-t1n.nii.gz,../../DataSet/BraTS2024-BraTS-GLI-TrainingData/BraTS-GLI-02891-100/BraTS-GLI-02891-100-seg.nii.gz,63,60,98,40,85,29,98,72,126,45,69,54
02344-100,../../DataSet/BraTS2024-BraTS-GLI-TrainingData/BraTS-GLI-02344-100/BraTS-GLI-02344-100-t1c.nii.gz,../../DataSet/BraTS2024-BraTS-GLI-TrainingData/BraTS-GLI-02344-100/BraTS-GLI-02344-100-t2w.nii.gz,../../DataSet/BraTS2024-BraTS-GLI-TrainingData/BraTS-GLI-02344-100/BraTS-GLI-02344-100-t2f.nii.gz,../../DataSet/BraTS2024-BraTS-GLI-TrainingData/BraTS-GLI-02344-100/BraTS-GLI-02344-100-t1n.nii.gz,../../DataSet/BraTS2024-BraTS-GLI-TrainingData/BraTS-GLI-02344-100/BraTS-GLI-02344-100-seg.nii.gz,81,130,86,60,101,111,150,71,102,41,39,31
02561-101,../../DataSet/BraTS2024-BraTS-GLI-TrainingData/BraTS-GLI-02561-101/BraTS-GLI-02561-101-t1c.nii.gz,../../DataSet/BraTS2024-BraTS-GLI-TrainingData/BraTS-GLI-02561-101/BraTS-GLI-02561-101-t2w.nii.gz,../../DataSet/BraTS2024-BraTS-GLI-TrainingData/BraTS-GLI-02561-101/BraTS-GLI-02561-101-t2f.nii.gz,../../DataSet/BraTS2024-BraTS-GLI-TrainingData/BraTS-GLI-02561-101/BraTS-GLI-02561-101-t1n.nii.gz,../../DataSet/BraTS2024-BraTS-GLI-TrainingData/BraTS-GLI-02561-101/BraTS-GLI-02561-101-seg.nii.gz,71,134,99,45,99,92,171,69,119,54,79,50
02725-100,../../DataSet/BraTS2024-BraTS-GLI-TrainingData/BraTS-GLI-02725-100/BraTS-GLI-02725-100-t1c.nii.gz,../../DataSet/BraTS2024-BraTS-GLI-TrainingData/BraTS-GLI-02725-100/BraTS-GLI-02725-100-t2w.nii.gz,../../DataSet/BraTS2024-BraTS-GLI-TrainingData/BraTS-GLI-02725-100/BraTS-GLI-02725-100-t2f.nii.gz,../../DataSet/BraTS2024-BraTS-GLI-TrainingData/BraTS-GLI-02725-100/BraTS-GLI-02725-100-t1n.nii.gz,../../DataSet/BraTS2024-BraTS-GLI-TrainingData/BraTS-GLI-02725-100/BraTS-GLI-02725-100-seg.nii.gz,103,116,124,90,127,77,142,103,152,37,65,49
02093-107,../../DataSet/BraTS2024-BraTS-GLI-TrainingData/BraTS-GLI-02093-107/BraTS-GLI-02093-107-t1c.nii.gz,../../DataSet/BraTS2024-BraTS-GLI-TrainingData/BraTS-GLI-02093-107/BraTS-GLI-02093-107-t2w.nii.gz,../../DataSet/BraTS2024-BraTS-GLI-TrainingData/BraTS-GLI-02093-107/BraTS-GLI-02093-107-t2f.nii.gz,../../DataSet/BraTS2024-BraTS-GLI-TrainingData/BraTS-GLI-02093-107/BraTS-GLI-02093-107-t1n.nii.gz,../../DataSet/BraTS2024-BraTS-GLI-TrainingData/BraTS-GLI-02093-107/BraTS-GLI-02093-107-seg.nii.gz,109,170,95,68,141,119,200,53,143,73,81,90
00549-100,../../DataSet/BraTS2024-BraTS-GLI-TrainingData/BraTS-GLI-00549-100/BraTS-GLI-00549-100-t1c.nii.gz,../../DataSet/BraTS2024-BraTS-GLI-TrainingData/BraTS-GLI-00549-100/BraTS-GLI-00549-100-t2w.nii.gz,../../DataSet/BraTS2024-BraTS-GLI-TrainingData/BraTS-GLI-00549-100/BraTS-GLI-00549-100-t2f.nii.gz,../../DataSet/BraTS2024-BraTS-GLI-TrainingData/BraTS-GLI-00549-100/BraTS-GLI-00549-100-t1n.nii.gz,../../DataSet/BraTS2024-BraTS-GLI-TrainingData/BraTS-GLI-00549-100/BraTS-GLI-00549-100-seg.nii.gz,69,150,103,46,83,125,172,89,127,37,47,38
02918-100,../../DataSet/BraTS2024-BraTS-GLI-TrainingData/BraTS-GLI-02918-100/BraTS-GLI-02918-100-t1c.nii.gz,../../DataSet/BraTS2024-BraTS-GLI-TrainingData/BraTS-GLI-02918-100/BraTS-GLI-02918-100-t2w.nii.gz,../../DataSet/BraTS2024-BraTS-GLI-TrainingData/BraTS-GLI-02918-100/BraTS-GLI-02918-100-t2f.nii.gz,../../DataSet/BraTS2024-BraTS-GLI-TrainingData/BraTS-GLI-02918-100/BraTS-GLI-02918-100-t1n.nii.gz,../../DataSet/BraTS2024-BraTS-GLI-TrainingData/BraTS-GLI-02918-100/BraTS-GLI-02918-100-seg.nii.gz,107,131,129,73,131,90,168,98,158,58,78,60
02149-101,../../DataSet/BraTS2024-BraTS-GLI-TrainingData/BraTS-GLI-02149-101/BraTS-GLI-02149-101-t1c.nii.gz,../../DataSet/BraTS2024-BraTS-GLI-TrainingData/BraTS-GLI-02149-101/BraTS-GLI-02149-101-t2w.nii.gz,../../DataSet/BraTS2024-BraTS-GLI-TrainingData/BraTS-GLI-02149-101/BraTS-GLI-02149-101-t2f.nii.gz,../../DataSet/BraTS2024-BraTS-GLI-TrainingData/BraTS-GLI-02149-101/BraTS-GLI-02149-101-t1n.nii.gz,../../DataSet/BraTS2024-BraTS-GLI-TrainingData/BraTS-GLI-02149-101/BraTS-GLI-02149-101-seg.nii.gz,107,82,123,74,128,55,111,89,150,54,56,61
02809-100,../../DataSet/BraTS2024-BraTS-GLI-TrainingData/BraTS-GLI-02809-100/BraTS-GLI-02809-100-t1c.nii.gz,../../DataSet/BraTS2024-BraTS-GLI-TrainingData/BraTS-GLI-02809-100/BraTS-GLI-02809-100-t2w.nii.gz,../../DataSet/BraTS2024-BraTS-GLI-TrainingData/BraTS-GLI-02809-100/BraTS-GLI-02809-100-t2f.nii.gz,../../DataSet/BraTS2024-BraTS-GLI-TrainingData/BraTS-GLI-02809-100/BraTS-GLI-02809-100-t1n.nii.gz,../../DataSet/BraTS2024-BraTS-GLI-TrainingData/BraTS-GLI-02809-100/BraTS-GLI-02809-100-seg.nii.gz,72,148,121,54,89,115,180,92,146,35,65,54
02198-101,../../DataSet/BraTS2024-BraTS-GLI-TrainingData/BraTS-GLI-02198-101/BraTS-GLI-02198-101-t1c.nii.gz,../../DataSet/BraTS2024-BraTS-GLI-TrainingData/BraTS-GLI-02198-101/BraTS-GLI-02198-101-t2w.nii.gz,../../DataSet/BraTS2024-BraTS-GLI-TrainingData/BraTS-GLI-02198-101/BraTS-GLI-02198-101-t2f.nii.gz,../../DataSet/BraTS2024-BraTS-GLI-TrainingData/BraTS-GLI-02198-101/BraTS-GLI-02198-101-t1n.nii.gz,../../DataSet/BraTS2024-BraTS-GLI-TrainingData/BraTS-GLI-02198-101/BraTS-GLI-02198-101-seg.nii.gz,63,68,96,34,123,29,120,64,132,89,91,68
02767-101,../../DataSet/BraTS2024-BraTS-GLI-TrainingData/BraTS-GLI-02767-101/BraTS-GLI-02767-101-t1c.nii.gz,../../DataSet/BraTS2024-BraTS-GLI-TrainingData/BraTS-GLI-02767-101/BraTS-GLI-02767-101-t2w.nii.gz,../../DataSet/BraTS2024-BraTS-GLI-TrainingData/BraTS-GLI-02767-101/BraTS-GLI-02767-101-t2f.nii.gz,../../DataSet/BraTS2024-BraTS-GLI-TrainingData/BraTS-GLI-02767-101/BraTS-GLI-02767-101-t1n.nii.gz,../../DataSet/BraTS2024-BraTS-GLI-TrainingData/BraTS-GLI-02767-101/BraTS-GLI-02767-101-seg.nii.gz,97,91,24,91,104,85,97,17,33,13,12,16
02193-100,../../DataSet/BraTS2024-BraTS-GLI-TrainingData/BraTS-GLI-02193-100/BraTS-GLI-02193-100-t1c.nii.gz,../../DataSet/BraTS2024-BraTS-GLI-TrainingData/BraTS-GLI-02193-100/BraTS-GLI-02193-100-t2w.nii.gz,../../DataSet/BraTS2024-BraTS-GLI-TrainingData/BraTS-GLI-02193-100/BraTS-GLI-02193-100-t2f.nii.gz,../../DataSet/BraTS2024-BraTS-GLI-TrainingData/BraTS-GLI-02193-100/BraTS-GLI-02193-100-t1n.nii.gz,../../DataSet/BraTS2024-BraTS-GLI-TrainingData/BraTS-GLI-02193-100/BraTS-GLI-02193-100-seg.nii.gz,124,81,115,96,152,49,127,78,146,56,78,68
02634-100,../../DataSet/BraTS2024-BraTS-GLI-TrainingData/BraTS-GLI-02634-100/BraTS-GLI-02634-100-t1c.nii.gz,../../DataSet/BraTS2024-BraTS-GLI-TrainingData/BraTS-GLI-02634-100/BraTS-GLI-02634-100-t2w.nii.gz,../../DataSet/BraTS2024-BraTS-GLI-TrainingData/BraTS-GLI-02634-100/BraTS-GLI-02634-100-t2f.nii.gz,../../DataSet/BraTS2024-BraTS-GLI-TrainingData/BraTS-GLI-02634-100/BraTS-GLI-02634-100-t1n.nii.gz,../../DataSet/BraTS2024-BraTS-GLI-TrainingData/BraTS-GLI-02634-100/BraTS-GLI-02634-100-seg.nii.gz,124,118,62,103,150,91,142,43,81,47,51,38
02980-100,../../DataSet/BraTS2024-BraTS-GLI-TrainingData/BraTS-GLI-02980-100/BraTS-GLI-02980-100-t1c.nii.gz,../../DataSet/BraTS2024-BraTS-GLI-TrainingData/BraTS-GLI-02980-100/BraTS-GLI-02980-100-t2w.nii.gz,../../DataSet/BraTS2024-BraTS-GLI-TrainingData/BraTS-GLI-02980-100/BraTS-GLI-02980-100-t2f.nii.gz,../../DataSet/BraTS2024-BraTS-GLI-TrainingData/BraTS-GLI-02980-100/BraTS-GLI-02980-100-t1n.nii.gz,../../DataSet/BraTS2024-BraTS-GLI-TrainingData/BraTS-GLI-02980-100/BraTS-GLI-02980-100-seg.nii.gz,57,127,87,37,79,68,154,66,105,42,86,39
02802-101,../../DataSet/BraTS2024-BraTS-GLI-TrainingData/BraTS-GLI-02802-101/BraTS-GLI-02802-101-t1c.nii.gz,../../DataSet/BraTS2024-BraTS-GLI-TrainingData/BraTS-GLI-02802-101/BraTS-GLI-02802-101-t2w.nii.gz,../../DataSet/BraTS2024-BraTS-GLI-TrainingData/BraTS-GLI-02802-101/BraTS-GLI-02802-101-t2f.nii.gz,../../DataSet/BraTS2024-BraTS-GLI-TrainingData/BraTS-GLI-02802-101/BraTS-GLI-02802-101-t1n.nii.gz,../../DataSet/BraTS2024-BraTS-GLI-TrainingData/BraTS-GLI-02802-101/BraTS-GLI-02802-101-seg.nii.gz,108,90,127,87,140,50,132,100,156,53,82,56
02875-100,../../DataSet/BraTS2024-BraTS-GLI-TrainingData/BraTS-GLI-02875-100/BraTS-GLI-02875-100-t1c.nii.gz,../../DataSet/BraTS2024-BraTS-GLI-TrainingData/BraTS-GLI-02875-100/BraTS-GLI-02875-100-t2w.nii.gz,../../DataSet/BraTS2024-BraTS-GLI-TrainingData/BraTS-GLI-02875-100/BraTS-GLI-02875-100-t2f.nii.gz,../../DataSet/BraTS2024-BraTS-GLI-TrainingData/BraTS-GLI-02875-100/BraTS-GLI-02875-100-t1n.nii.gz,../../DataSet/BraTS2024-BraTS-GLI-TrainingData/BraTS-GLI-02875-100/BraTS-GLI-02875-100-seg.nii.gz,72,145,109,34,114,92,182,68,145,80,90,77
02648-100,../../DataSet/BraTS2024-BraTS-GLI-TrainingData/BraTS-GLI-02648-100/BraTS-GLI-02648-100-t1c.nii.gz,../../DataSet/BraTS2024-BraTS-GLI-TrainingData/BraTS-GLI-02648-100/BraTS-GLI-02648-100-t2w.nii.gz,../../DataSet/BraTS2024-BraTS-GLI-TrainingData/BraTS-GLI-02648-100/BraTS-GLI-02648-100-t2f.nii.gz,../../DataSet/BraTS2024-BraTS-GLI-TrainingData/BraTS-GLI-02648-100/BraTS-GLI-02648-100-t1n.nii.gz,../../DataSet/BraTS2024-BraTS-GLI-TrainingData/BraTS-GLI-02648-100/BraTS-GLI-02648-100-seg.nii.gz,59,154,104,34,111,133,180,82,133,77,47,51
02229-100,../../DataSet/BraTS2024-BraTS-GLI-TrainingData/BraTS-GLI-02229-100/BraTS-GLI-02229-100-t1c.nii.gz,../../DataSet/BraTS2024-BraTS-GLI-TrainingData/BraTS-GLI-02229-100/BraTS-GLI-02229-100-t2w.nii.gz,../../DataSet/BraTS2024-BraTS-GLI-TrainingData/BraTS-GLI-02229-100/BraTS-GLI-02229-100-t2f.nii.gz,../../DataSet/BraTS2024-BraTS-GLI-TrainingData/BraTS-GLI-02229-100/BraTS-GLI-02229-100-t1n.nii.gz,../../DataSet/BraTS2024-BraTS-GLI-TrainingData/BraTS-GLI-02229-100/BraTS-GLI-02229-100-seg.nii.gz,79,136,117,40,131,93,174,85,149,91,81,64
02132-101,../../DataSet/BraTS2024-BraTS-GLI-TrainingData/BraTS-GLI-02132-101/BraTS-GLI-02132-101-t1c.nii.gz,../../DataSet/BraTS2024-BraTS-GLI-TrainingData/BraTS-GLI-02132-101/BraTS-GLI-02132-101-t2w.nii.gz,../../DataSet/BraTS2024-BraTS-GLI-TrainingData/BraTS-GLI-02132-101/BraTS-GLI-02132-101-t2f.nii.gz,../../DataSet/BraTS2024-BraTS-GLI-TrainingData/BraTS-GLI-02132-101/BraTS-GLI-02132-101-t1n.nii.gz,../../DataSet/BraTS2024-BraTS-GLI-TrainingData/BraTS-GLI-02132-101/BraTS-GLI-02132-101-seg.nii.gz,101,131,118,71,123,104,157,90,149,52,53,59
02717-100,../../DataSet/BraTS2024-BraTS-GLI-TrainingData/BraTS-GLI-02717-100/BraTS-GLI-02717-100-t1c.nii.gz,../../DataSet/BraTS2024-BraTS-GLI-TrainingData/BraTS-GLI-02717-100/BraTS-GLI-02717-100-t2w.nii.gz,../../DataSet/BraTS2024-BraTS-GLI-TrainingData/BraTS-GLI-02717-100/BraTS-GLI-02717-100-t2f.nii.gz,../../DataSet/BraTS2024-BraTS-GLI-TrainingData/BraTS-GLI-02717-100/BraTS-GLI-02717-100-t1n.nii.gz,../../DataSet/BraTS2024-BraTS-GLI-TrainingData/BraTS-GLI-02717-100/BraTS-GLI-02717-100-seg.nii.gz,70,63,36,54,89,42,102,18,58,35,60,40
02553-101,../../DataSet/BraTS2024-BraTS-GLI-TrainingData/BraTS-GLI-02553-101/BraTS-GLI-02553-101-t1c.nii.gz,../../DataSet/BraTS2024-BraTS-GLI-TrainingData/BraTS-GLI-02553-101/BraTS-GLI-02553-101-t2w.nii.gz,../../DataSet/BraTS2024-BraTS-GLI-TrainingData/BraTS-GLI-02553-101/BraTS-GLI-02553-101-t2f.nii.gz,../../DataSet/BraTS2024-BraTS-GLI-TrainingData/BraTS-GLI-02553-101/BraTS-GLI-02553-101-t1n.nii.gz,../../DataSet/BraTS2024-BraTS-GLI-TrainingData/BraTS-GLI-02553-101/BraTS-GLI-02553-101-seg.nii.gz,64,62,87,32,102,24,111,60,123,70,87,63
02092-104,../../DataSet/BraTS2024-BraTS-GLI-TrainingData/BraTS-GLI-02092-104/BraTS-GLI-02092-104-t1c.nii.gz,../../DataSet/BraTS2024-BraTS-GLI-TrainingData/BraTS-GLI-02092-104/BraTS-GLI-02092-104-t2w.nii.gz,../../DataSet/BraTS2024-BraTS-GLI-TrainingData/BraTS-GLI-02092-104/BraTS-GLI-02092-104-t2f.nii.gz,../../DataSet/BraTS2024-BraTS-GLI-TrainingData/BraTS-GLI-02092-104/BraTS-GLI-02092-104-t1n.nii.gz,../../DataSet/BraTS2024-BraTS-GLI-TrainingData/BraTS-GLI-02092-104/BraTS-GLI-02092-104-seg.nii.gz,96,158,99,57,125,107,194,64,135,68,87,71
02061-100,../../DataSet/BraTS2024-BraTS-GLI-TrainingData/BraTS-GLI-02061-100/BraTS-GLI-02061-100-t1c.nii.gz,../../DataSet/BraTS2024-BraTS-GLI-TrainingData/BraTS-GLI-02061-100/BraTS-GLI-02061-100-t2w.nii.gz,../../DataSet/BraTS2024-BraTS-GLI-TrainingData/BraTS-GLI-02061-100/BraTS-GLI-02061-100-t2f.nii.gz,../../DataSet/BraTS2024-BraTS-GLI-TrainingData/BraTS-GLI-02061-100/BraTS-GLI-02061-100-t1n.nii.gz,../../DataSet/BraTS2024-BraTS-GLI-TrainingData/BraTS-GLI-02061-100/BraTS-GLI-02061-100-seg.nii.gz,106,96,128,74,134,68,148,100,153,60,80,53
02558-100,../../DataSet/BraTS2024-BraTS-GLI-TrainingData/BraTS-GLI-02558-100/BraTS-GLI-02558-100-t1c.nii.gz,../../DataSet/BraTS2024-BraTS-GLI-TrainingData/BraTS-GLI-02558-100/BraTS-GLI-02558-100-t2w.nii.gz,../../DataSet/BraTS2024-BraTS-GLI-TrainingData/BraTS-GLI-02558-100/BraTS-GLI-02558-100-t2f.nii.gz,../../DataSet/BraTS2024-BraTS-GLI-TrainingData/BraTS-GLI-02558-100/BraTS-GLI-02558-100-t1n.nii.gz,../../DataSet/BraTS2024-BraTS-GLI-TrainingData/BraTS-GLI-02558-100/BraTS-GLI-02558-100-seg.nii.gz,66,85,74,41,99,43,127,52,104,58,84,52
02083-103,../../DataSet/BraTS2024-BraTS-GLI-TrainingData/BraTS-GLI-02083-103/BraTS-GLI-02083-103-t1c.nii.gz,../../DataSet/BraTS2024-BraTS-GLI-TrainingData/BraTS-GLI-02083-103/BraTS-GLI-02083-103-t2w.nii.gz,../../DataSet/BraTS2024-BraTS-GLI-TrainingData/BraTS-GLI-02083-103/BraTS-GLI-02083-103-t2f.nii.gz,../../DataSet/BraTS2024-BraTS-GLI-TrainingData/BraTS-GLI-02083-103/BraTS-GLI-02083-103-t1n.nii.gz,../../DataSet/BraTS2024-BraTS-GLI-TrainingData/BraTS-GLI-02083-103/BraTS-GLI-02083-103-seg.nii.gz,69,99,130,43,90,57,144,100,160,47,87,60
02216-102,../../DataSet/BraTS2024-BraTS-GLI-TrainingData/BraTS-GLI-02216-102/BraTS-GLI-02216-102-t1c.nii.gz,../../DataSet/BraTS2024-BraTS-GLI-TrainingData/BraTS-GLI-02216-102/BraTS-GLI-02216-102-t2w.nii.gz,../../DataSet/BraTS2024-BraTS-GLI-TrainingData/BraTS-GLI-02216-102/BraTS-GLI-02216-102-t2f.nii.gz,../../DataSet/BraTS2024-BraTS-GLI-TrainingData/BraTS-GLI-02216-102/BraTS-GLI-02216-102-t1n.nii.gz,../../DataSet/BraTS2024-BraTS-GLI-TrainingData/BraTS-GLI-02216-102/BraTS-GLI-02216-102-seg.nii.gz,74,152,116,55,90,123,181,83,144,35,58,61
02879-101,../../DataSet/BraTS2024-BraTS-GLI-TrainingData/BraTS-GLI-02879-101/BraTS-GLI-02879-101-t1c.nii.gz,../../DataSet/BraTS2024-BraTS-GLI-TrainingData/BraTS-GLI-02879-101/BraTS-GLI-02879-101-t2w.nii.gz,../../DataSet/BraTS2024-BraTS-GLI-TrainingData/BraTS-GLI-02879-101/BraTS-GLI-02879-101-t2f.nii.gz,../../DataSet/BraTS2024-BraTS-GLI-TrainingData/BraTS-GLI-02879-101/BraTS-GLI-02879-101-t1n.nii.gz,../../DataSet/BraTS2024-BraTS-GLI-TrainingData/BraTS-GLI-02879-101/BraTS-GLI-02879-101-seg.nii.gz,125,125,98,106,147,99,148,69,118,41,49,49
02524-100,../../DataSet/BraTS2024-BraTS-GLI-TrainingData/BraTS-GLI-02524-100/BraTS-GLI-02524-100-t1c.nii.gz,../../DataSet/BraTS2024-BraTS-GLI-TrainingData/BraTS-GLI-02524-100/BraTS-GLI-02524-100-t2w.nii.gz,../../DataSet/BraTS2024-BraTS-GLI-TrainingData/BraTS-GLI-02524-100/BraTS-GLI-02524-100-t2f.nii.gz,../../DataSet/BraTS2024-BraTS-GLI-TrainingData/BraTS-GLI-02524-100/BraTS-GLI-02524-100-t1n.nii.gz,../../DataSet/BraTS2024-BraTS-GLI-TrainingData/BraTS-GLI-02524-100/BraTS-GLI-02524-100-seg.nii.gz,106,107,123,89,130,86,131,102,142,41,45,40
02145-100,../../DataSet/BraTS2024-BraTS-GLI-TrainingData/BraTS-GLI-02145-100/BraTS-GLI-02145-100-t1c.nii.gz,../../DataSet/BraTS2024-BraTS-GLI-TrainingData/BraTS-GLI-02145-100/BraTS-GLI-02145-100-t2w.nii.gz,../../DataSet/BraTS2024-BraTS-GLI-TrainingData/BraTS-GLI-02145-100/BraTS-GLI-02145-100-t2f.nii.gz,../../DataSet/BraTS2024-BraTS-GLI-TrainingData/BraTS-GLI-02145-100/BraTS-GLI-02145-100-t1n.nii.gz,../../DataSet/BraTS2024-BraTS-GLI-TrainingData/BraTS-GLI-02145-100/BraTS-GLI-02145-100-seg.nii.gz,75,63,111,58,107,42,83,81,142,49,41,61
02760-101,../../DataSet/BraTS2024-BraTS-GLI-TrainingData/BraTS-GLI-02760-101/BraTS-GLI-02760-101-t1c.nii.gz,../../DataSet/BraTS2024-BraTS-GLI-TrainingData/BraTS-GLI-02760-101/BraTS-GLI-02760-101-t2w.nii.gz,../../DataSet/BraTS2024-BraTS-GLI-TrainingData/BraTS-GLI-02760-101/BraTS-GLI-02760-101-t2f.nii.gz,../../DataSet/BraTS2024-BraTS-GLI-TrainingData/BraTS-GLI-02760-101/BraTS-GLI-02760-101-t1n.nii.gz,../../DataSet/BraTS2024-BraTS-GLI-TrainingData/BraTS-GLI-02760-101/BraTS-GLI-02760-101-seg.nii.gz,64,129,104,41,81,99,176,82,131,40,77,49
02633-100,../../DataSet/BraTS2024-BraTS-GLI-TrainingData/BraTS-GLI-02633-100/BraTS-GLI-02633-100-t1c.nii.gz,../../DataSet/BraTS2024-BraTS-GLI-TrainingData/BraTS-GLI-02633-100/BraTS-GLI-02633-100-t2w.nii.gz,../../DataSet/BraTS2024-BraTS-GLI-TrainingData/BraTS-GLI-02633-100/BraTS-GLI-02633-100-t2f.nii.gz,../../DataSet/BraTS2024-BraTS-GLI-TrainingData/BraTS-GLI-02633-100/BraTS-GLI-02633-100-t1n.nii.gz,../../DataSet/BraTS2024-BraTS-GLI-TrainingData/BraTS-GLI-02633-100/BraTS-GLI-02633-100-seg.nii.gz,114,120,68,89,137,91,145,36,97,48,54,61
00507-100,../../DataSet/BraTS2024-BraTS-GLI-TrainingData/BraTS-GLI-00507-100/BraTS-GLI-00507-100-t1c.nii.gz,../../DataSet/BraTS2024-BraTS-GLI-TrainingData/BraTS-GLI-00507-100/BraTS-GLI-00507-100-t2w.nii.gz,../../DataSet/BraTS2024-BraTS-GLI-TrainingData/BraTS-GLI-00507-100/BraTS-GLI-00507-100-t2f.nii.gz,../../DataSet/BraTS2024-BraTS-GLI-TrainingData/BraTS-GLI-00507-100/BraTS-GLI-00507-100-t1n.nii.gz,../../DataSet/BraTS2024-BraTS-GLI-TrainingData/BraTS-GLI-00507-100/BraTS-GLI-00507-100-seg.nii.gz,108,161,106,91,132,120,187,87,131,41,67,44
02987-100,../../DataSet/BraTS2024-BraTS-GLI-TrainingData/BraTS-GLI-02987-100/BraTS-GLI-02987-100-t1c.nii.gz,../../DataSet/BraTS2024-BraTS-GLI-TrainingData/BraTS-GLI-02987-100/BraTS-GLI-02987-100-t2w.nii.gz,../../DataSet/BraTS2024-BraTS-GLI-TrainingData/BraTS-GLI-02987-100/BraTS-GLI-02987-100-t2f.nii.gz,../../DataSet/BraTS2024-BraTS-GLI-TrainingData/BraTS-GLI-02987-100/BraTS-GLI-02987-100-t1n.nii.gz,../../DataSet/BraTS2024-BraTS-GLI-TrainingData/BraTS-GLI-02987-100/BraTS-GLI-02987-100-seg.nii.gz,116,69,109,93,153,28,117,64,150,60,89,86
02719-100,../../DataSet/BraTS2024-BraTS-GLI-TrainingData/BraTS-GLI-02719-100/BraTS-GLI-02719-100-t1c.nii.gz,../../DataSet/BraTS2024-BraTS-GLI-TrainingData/BraTS-GLI-02719-100/BraTS-GLI-02719-100-t2w.nii.gz,../../DataSet/BraTS2024-BraTS-GLI-TrainingData/BraTS-GLI-02719-100/BraTS-GLI-02719-100-t2f.nii.gz,../../DataSet/BraTS2024-BraTS-GLI-TrainingData/BraTS-GLI-02719-100/BraTS-GLI-02719-100-t1n.nii.gz,../../DataSet/BraTS2024-BraTS-GLI-TrainingData/BraTS-GLI-02719-100/BraTS-GLI-02719-100-seg.nii.gz,59,142,115,34,82,105,167,85,139,48,62,54
02378-100,../../DataSet/BraTS2024-BraTS-GLI-TrainingData/BraTS-GLI-02378-100/BraTS-GLI-02378-100-t1c.nii.gz,../../DataSet/BraTS2024-BraTS-GLI-TrainingData/BraTS-GLI-02378-100/BraTS-GLI-02378-100-t2w.nii.gz,../../DataSet/BraTS2024-BraTS-GLI-TrainingData/BraTS-GLI-02378-100/BraTS-GLI-02378-100-t2f.nii.gz,../../DataSet/BraTS2024-BraTS-GLI-TrainingData/BraTS-GLI-02378-100/BraTS-GLI-02378-100-t1n.nii.gz,../../DataSet/BraTS2024-BraTS-GLI-TrainingData/BraTS-GLI-02378-100/BraTS-GLI-02378-100-seg.nii.gz,93,119,128,60,128,66,153,88,158,68,87,70
02137-100,../../DataSet/BraTS2024-BraTS-GLI-TrainingData/BraTS-GLI-02137-100/BraTS-GLI-02137-100-t1c.nii.gz,../../DataSet/BraTS2024-BraTS-GLI-TrainingData/BraTS-GLI-02137-100/BraTS-GLI-02137-100-t2w.nii.gz,../../DataSet/BraTS2024-BraTS-GLI-TrainingData/BraTS-GLI-02137-100/BraTS-GLI-02137-100-t2f.nii.gz,../../DataSet/BraTS2024-BraTS-GLI-TrainingData/BraTS-GLI-02137-100/BraTS-GLI-02137-100-t1n.nii.gz,../../DataSet/BraTS2024-BraTS-GLI-TrainingData/BraTS-GLI-02137-100/BraTS-GLI-02137-100-seg.nii.gz,43,81,92,21,74,53,108,62,131,53,55,69
02218-102,../../DataSet/BraTS2024-BraTS-GLI-TrainingData/BraTS-GLI-02218-102/BraTS-GLI-02218-102-t1c.nii.gz,../../DataSet/BraTS2024-BraTS-GLI-TrainingData/BraTS-GLI-02218-102/BraTS-GLI-02218-102-t2w.nii.gz,../../DataSet/BraTS2024-BraTS-GLI-TrainingData/BraTS-GLI-02218-102/BraTS-GLI-02218-102-t2f.nii.gz,../../DataSet/BraTS2024-BraTS-GLI-TrainingData/BraTS-GLI-02218-102/BraTS-GLI-02218-102-t1n.nii.gz,../../DataSet/BraTS2024-BraTS-GLI-TrainingData/BraTS-GLI-02218-102/BraTS-GLI-02218-102-seg.nii.gz,123,129,78,99,146,99,157,46,106,47,58,60
02220-100,../../DataSet/BraTS2024-BraTS-GLI-TrainingData/BraTS-GLI-02220-100/BraTS-GLI-02220-100-t1c.nii.gz,../../DataSet/BraTS2024-BraTS-GLI-TrainingData/BraTS-GLI-02220-100/BraTS-GLI-02220-100-t2w.nii.gz,../../DataSet/BraTS2024-BraTS-GLI-TrainingData/BraTS-GLI-02220-100/BraTS-GLI-02220-100-t2f.nii.gz,../../DataSet/BraTS2024-BraTS-GLI-TrainingData/BraTS-GLI-02220-100/BraTS-GLI-02220-100-t1n.nii.gz,../../DataSet/BraTS2024-BraTS-GLI-TrainingData/BraTS-GLI-02220-100/BraTS-GLI-02220-100-seg.nii.gz,127,119,110,104,151,91,149,82,146,47,58,64
02877-101,../../DataSet/BraTS2024-BraTS-GLI-TrainingData/BraTS-GLI-02877-101/BraTS-GLI-02877-101-t1c.nii.gz,../../DataSet/BraTS2024-BraTS-GLI-TrainingData/BraTS-GLI-02877-101/BraTS-GLI-02877-101-t2w.nii.gz,../../DataSet/BraTS2024-BraTS-GLI-TrainingData/BraTS-GLI-02877-101/BraTS-GLI-02877-101-t2f.nii.gz,../../DataSet/BraTS2024-BraTS-GLI-TrainingData/BraTS-GLI-02877-101/BraTS-GLI-02877-101-t1n.nii.gz,../../DataSet/BraTS2024-BraTS-GLI-TrainingData/BraTS-GLI-02877-101/BraTS-GLI-02877-101-seg.nii.gz,141,125,99,125,152,114,144,83,113,27,30,30
00008-102,../../DataSet/BraTS2024-BraTS-GLI-TrainingData/BraTS-GLI-00008-102/BraTS-GLI-00008-102-t1c.nii.gz,../../DataSet/BraTS2024-BraTS-GLI-TrainingData/BraTS-GLI-00008-102/BraTS-GLI-00008-102-t2w.nii.gz,../../DataSet/BraTS2024-BraTS-GLI-TrainingData/BraTS-GLI-00008-102/BraTS-GLI-00008-102-t2f.nii.gz,../../DataSet/BraTS2024-BraTS-GLI-TrainingData/BraTS-GLI-00008-102/BraTS-GLI-00008-102-t1n.nii.gz,../../DataSet/BraTS2024-BraTS-GLI-TrainingData/BraTS-GLI-00008-102/BraTS-GLI-00008-102-seg.nii.gz,49,73,71,31,75,40,102,49,100,44,62,51
02765-100,../../DataSet/BraTS2024-BraTS-GLI-TrainingData/BraTS-GLI-02765-100/BraTS-GLI-02765-100-t1c.nii.gz,../../DataSet/BraTS2024-BraTS-GLI-TrainingData/BraTS-GLI-02765-100/BraTS-GLI-02765-100-t2w.nii.gz,../../DataSet/BraTS2024-BraTS-GLI-TrainingData/BraTS-GLI-02765-100/BraTS-GLI-02765-100-t2f.nii.gz,../../DataSet/BraTS2024-BraTS-GLI-TrainingData/BraTS-GLI-02765-100/BraTS-GLI-02765-100-t1n.nii.gz,../../DataSet/BraTS2024-BraTS-GLI-TrainingData/BraTS-GLI-02765-100/BraTS-GLI-02765-100-seg.nii.gz,99,137,103,81,120,104,178,69,136,39,74,67
02953-101,../../DataSet/BraTS2024-BraTS-GLI-TrainingData/BraTS-GLI-02953-101/BraTS-GLI-02953-101-t1c.nii.gz,../../DataSet/BraTS2024-BraTS-GLI-TrainingData/BraTS-GLI-02953-101/BraTS-GLI-02953-101-t2w.nii.gz,../../DataSet/BraTS2024-BraTS-GLI-TrainingData/BraTS-GLI-02953-101/BraTS-GLI-02953-101-t2f.nii.gz,../../DataSet/BraTS2024-BraTS-GLI-TrainingData/BraTS-GLI-02953-101/BraTS-GLI-02953-101-t1n.nii.gz,../../DataSet/BraTS2024-BraTS-GLI-TrainingData/BraTS-GLI-02953-101/BraTS-GLI-02953-101-seg.nii.gz,104,114,136,91,123,84,148,113,156,32,64,43
02982-101,../../DataSet/BraTS2024-BraTS-GLI-TrainingData/BraTS-GLI-02982-101/BraTS-GLI-02982-101-t1c.nii.gz,../../DataSet/BraTS2024-BraTS-GLI-TrainingData/BraTS-GLI-02982-101/BraTS-GLI-02982-101-t2w.nii.gz,../../DataSet/BraTS2024-BraTS-GLI-TrainingData/BraTS-GLI-02982-101/BraTS-GLI-02982-101-t2f.nii.gz,../../DataSet/BraTS2024-BraTS-GLI-TrainingData/BraTS-GLI-02982-101/BraTS-GLI-02982-101-t1n.nii.gz,../../DataSet/BraTS2024-BraTS-GLI-TrainingData/BraTS-GLI-02982-101/BraTS-GLI-02982-101-seg.nii.gz,56,132,73,32,82,104,154,49,107,50,50,58
02800-100,../../DataSet/BraTS2024-BraTS-GLI-TrainingData/BraTS-GLI-02800-100/BraTS-GLI-02800-100-t1c.nii.gz,../../DataSet/BraTS2024-BraTS-GLI-TrainingData/BraTS-GLI-02800-100/BraTS-GLI-02800-100-t2w.nii.gz,../../DataSet/BraTS2024-BraTS-GLI-TrainingData/BraTS-GLI-02800-100/BraTS-GLI-02800-100-t2f.nii.gz,../../DataSet/BraTS2024-BraTS-GLI-TrainingData/BraTS-GLI-02800-100/BraTS-GLI-02800-100-t1n.nii.gz,../../DataSet/BraTS2024-BraTS-GLI-TrainingData/BraTS-GLI-02800-100/BraTS-GLI-02800-100-seg.nii.gz,67,139,97,39,95,103,175,73,128,56,72,55
02958-100,../../DataSet/BraTS2024-BraTS-GLI-TrainingData/BraTS-GLI-02958-100/BraTS-GLI-02958-100-t1c.nii.gz,../../DataSet/BraTS2024-BraTS-GLI-TrainingData/BraTS-GLI-02958-100/BraTS-GLI-02958-100-t2w.nii.gz,../../DataSet/BraTS2024-BraTS-GLI-TrainingData/BraTS-GLI-02958-100/BraTS-GLI-02958-100-t2f.nii.gz,../../DataSet/BraTS2024-BraTS-GLI-TrainingData/BraTS-GLI-02958-100/BraTS-GLI-02958-100-t1n.nii.gz,../../DataSet/BraTS2024-BraTS-GLI-TrainingData/BraTS-GLI-02958-100/BraTS-GLI-02958-100-seg.nii.gz,115,117,113,69,148,72,165,80,149,79,93,69
02989-100,../../DataSet/BraTS2024-BraTS-GLI-TrainingData/BraTS-GLI-02989-100/BraTS-GLI-02989-100-t1c.nii.gz,../../DataSet/BraTS2024-BraTS-GLI-TrainingData/BraTS-GLI-02989-100/BraTS-GLI-02989-100-t2w.nii.gz,../../DataSet/BraTS2024-BraTS-GLI-TrainingData/BraTS-GLI-02989-100/BraTS-GLI-02989-100-t2f.nii.gz,../../DataSet/BraTS2024-BraTS-GLI-TrainingData/BraTS-GLI-02989-100/BraTS-GLI-02989-100-t1n.nii.gz,../../DataSet/BraTS2024-BraTS-GLI-TrainingData/BraTS-GLI-02989-100/BraTS-GLI-02989-100-seg.nii.gz,126,108,84,105,155,72,142,61,114,50,70,53
02954-101,../../DataSet/BraTS2024-BraTS-GLI-TrainingData/BraTS-GLI-02954-101/BraTS-GLI-02954-101-t1c.nii.gz,../../DataSet/BraTS2024-BraTS-GLI-TrainingData/BraTS-GLI-02954-101/BraTS-GLI-02954-101-t2w.nii.gz,../../DataSet/BraTS2024-BraTS-GLI-TrainingData/BraTS-GLI-02954-101/BraTS-GLI-02954-101-t2f.nii.gz,../../DataSet/BraTS2024-BraTS-GLI-TrainingData/BraTS-GLI-02954-101/BraTS-GLI-02954-101-t1n.nii.gz,../../DataSet/BraTS2024-BraTS-GLI-TrainingData/BraTS-GLI-02954-101/BraTS-GLI-02954-101-seg.nii.gz,76,142,108,65,98,123,160,94,131,33,37,37
02985-101,../../DataSet/BraTS2024-BraTS-GLI-TrainingData/BraTS-GLI-02985-101/BraTS-GLI-02985-101-t1c.nii.gz,../../DataSet/BraTS2024-BraTS-GLI-TrainingData/BraTS-GLI-02985-101/BraTS-GLI-02985-101-t2w.nii.gz,../../DataSet/BraTS2024-BraTS-GLI-TrainingData/BraTS-GLI-02985-101/BraTS-GLI-02985-101-t2f.nii.gz,../../DataSet/BraTS2024-BraTS-GLI-TrainingData/BraTS-GLI-02985-101/BraTS-GLI-02985-101-t1n.nii.gz,../../DataSet/BraTS2024-BraTS-GLI-TrainingData/BraTS-GLI-02985-101/BraTS-GLI-02985-101-seg.nii.gz,77,148,105,61,105,115,180,75,131,44,65,56
00505-101,../../DataSet/BraTS2024-BraTS-GLI-TrainingData/BraTS-GLI-00505-101/BraTS-GLI-00505-101-t1c.nii.gz,../../DataSet/BraTS2024-BraTS-GLI-TrainingData/BraTS-GLI-00505-101/BraTS-GLI-00505-101-t2w.nii.gz,../../DataSet/BraTS2024-BraTS-GLI-TrainingData/BraTS-GLI-00505-101/BraTS-GLI-00505-101-t2f.nii.gz,../../DataSet/BraTS2024-BraTS-GLI-TrainingData/BraTS-GLI-00505-101/BraTS-GLI-00505-101-t1n.nii.gz,../../DataSet/BraTS2024-BraTS-GLI-TrainingData/BraTS-GLI-00505-101/BraTS-GLI-00505-101-seg.nii.gz,130,77,93,100,154,36,116,66,131,54,80,65
02631-101,../../DataSet/BraTS2024-BraTS-GLI-TrainingData/BraTS-GLI-02631-101/BraTS-GLI-02631-101-t1c.nii.gz,../../DataSet/BraTS2024-BraTS-GLI-TrainingData/BraTS-GLI-02631-101/BraTS-GLI-02631-101-t2w.nii.gz,../../DataSet/BraTS2024-BraTS-GLI-TrainingData/BraTS-GLI-02631-101/BraTS-GLI-02631-101-t2f.nii.gz,../../DataSet/BraTS2024-BraTS-GLI-TrainingData/BraTS-GLI-02631-101/BraTS-GLI-02631-101-t1n.nii.gz,../../DataSet/BraTS2024-BraTS-GLI-TrainingData/BraTS-GLI-02631-101/BraTS-GLI-02631-101-seg.nii.gz,73,93,92,39,86,74,141,78,113,47,67,35
02196-101,../../DataSet/BraTS2024-BraTS-GLI-TrainingData/BraTS-GLI-02196-101/BraTS-GLI-02196-101-t1c.nii.gz,../../DataSet/BraTS2024-BraTS-GLI-TrainingData/BraTS-GLI-02196-101/BraTS-GLI-02196-101-t2w.nii.gz,../../DataSet/BraTS2024-BraTS-GLI-TrainingData/BraTS-GLI-02196-101/BraTS-GLI-02196-101-t2f.nii.gz,../../DataSet/BraTS2024-BraTS-GLI-TrainingData/BraTS-GLI-02196-101/BraTS-GLI-02196-101-t1n.nii.gz,../../DataSet/BraTS2024-BraTS-GLI-TrainingData/BraTS-GLI-02196-101/BraTS-GLI-02196-101-seg.nii.gz,81,154,101,42,130,113,192,56,140,88,79,84
02769-101,../../DataSet/BraTS2024-BraTS-GLI-TrainingData/BraTS-GLI-02769-101/BraTS-GLI-02769-101-t1c.nii.gz,../../DataSet/BraTS2024-BraTS-GLI-TrainingData/BraTS-GLI-02769-101/BraTS-GLI-02769-101-t2w.nii.gz,../../DataSet/BraTS2024-BraTS-GLI-TrainingData/BraTS-GLI-02769-101/BraTS-GLI-02769-101-t2f.nii.gz,../../DataSet/BraTS2024-BraTS-GLI-TrainingData/BraTS-GLI-02769-101/BraTS-GLI-02769-101-t1n.nii.gz,../../DataSet/BraTS2024-BraTS-GLI-TrainingData/BraTS-GLI-02769-101/BraTS-GLI-02769-101-seg.nii.gz,54,64,106,32,79,34,129,64,141,47,95,77
02081-102,../../DataSet/BraTS2024-BraTS-GLI-TrainingData/BraTS-GLI-02081-102/BraTS-GLI-02081-102-t1c.nii.gz,../../DataSet/BraTS2024-BraTS-GLI-TrainingData/BraTS-GLI-02081-102/BraTS-GLI-02081-102-t2w.nii.gz,../../DataSet/BraTS2024-BraTS-GLI-TrainingData/BraTS-GLI-02081-102/BraTS-GLI-02081-102-t2f.nii.gz,../../DataSet/BraTS2024-BraTS-GLI-TrainingData/BraTS-GLI-02081-102/BraTS-GLI-02081-102-t1n.nii.gz,../../DataSet/BraTS2024-BraTS-GLI-TrainingData/BraTS-GLI-02081-102/BraTS-GLI-02081-102-seg.nii.gz,106,169,89,71,133,138,196,57,133,62,58,76
02928-101,../../DataSet/BraTS2024-BraTS-GLI-TrainingData/BraTS-GLI-02928-101/BraTS-GLI-02928-101-t1c.nii.gz,../../DataSet/BraTS2024-BraTS-GLI-TrainingData/BraTS-GLI-02928-101/BraTS-GLI-02928-101-t2w.nii.gz,../../DataSet/BraTS2024-BraTS-GLI-TrainingData/BraTS-GLI-02928-101/BraTS-GLI-02928-101-t2f.nii.gz,../../DataSet/BraTS2024-BraTS-GLI-TrainingData/BraTS-GLI-02928-101/BraTS-GLI-02928-101-t1n.nii.gz,../../DataSet/BraTS2024-BraTS-GLI-TrainingData/BraTS-GLI-02928-101/BraTS-GLI-02928-101-seg.nii.gz,76,172,97,49,111,121,198,61,135,62,77,74
02068-100,../../DataSet/BraTS2024-BraTS-GLI-TrainingData/BraTS-GLI-02068-100/BraTS-GLI-02068-100-t1c.nii.gz,../../DataSet/BraTS2024-BraTS-GLI-TrainingData/BraTS-GLI-02068-100/BraTS-GLI-02068-100-t2w.nii.gz,../../DataSet/BraTS2024-BraTS-GLI-TrainingData/BraTS-GLI-02068-100/BraTS-GLI-02068-100-t2f.nii.gz,../../DataSet/BraTS2024-BraTS-GLI-TrainingData/BraTS-GLI-02068-100/BraTS-GLI-02068-100-t1n.nii.gz,../../DataSet/BraTS2024-BraTS-GLI-TrainingData/BraTS-GLI-02068-100/BraTS-GLI-02068-100-seg.nii.gz,115,56,94,91,136,24,108,69,123,45,84,54
02923-100,../../DataSet/BraTS2024-BraTS-GLI-TrainingData/BraTS-GLI-02923-100/BraTS-GLI-02923-100-t1c.nii.gz,../../DataSet/BraTS2024-BraTS-GLI-TrainingData/BraTS-GLI-02923-100/BraTS-GLI-02923-100-t2w.nii.gz,../../DataSet/BraTS2024-BraTS-GLI-TrainingData/BraTS-GLI-02923-100/BraTS-GLI-02923-100-t2f.nii.gz,../../DataSet/BraTS2024-BraTS-GLI-TrainingData/BraTS-GLI-02923-100/BraTS-GLI-02923-100-t1n.nii.gz,../../DataSet/BraTS2024-BraTS-GLI-TrainingData/BraTS-GLI-02923-100/BraTS-GLI-02923-100-seg.nii.gz,35,115,100,22,57,84,137,82,123,35,53,41
02205-104,../../DataSet/BraTS2024-BraTS-GLI-TrainingData/BraTS-GLI-02205-104/BraTS-GLI-02205-104-t1c.nii.gz,../../DataSet/BraTS2024-BraTS-GLI-TrainingData/BraTS-GLI-02205-104/BraTS-GLI-02205-104-t2w.nii.gz,../../DataSet/BraTS2024-BraTS-GLI-TrainingData/BraTS-GLI-02205-104/BraTS-GLI-02205-104-t2f.nii.gz,../../DataSet/BraTS2024-BraTS-GLI-TrainingData/BraTS-GLI-02205-104/BraTS-GLI-02205-104-t1n.nii.gz,../../DataSet/BraTS2024-BraTS-GLI-TrainingData/BraTS-GLI-02205-104/BraTS-GLI-02205-104-seg.nii.gz,104,139,117,90,129,108,177,78,152,39,69,74
03006-100,../../DataSet/BraTS2024-BraTS-GLI-TrainingData/BraTS-GLI-03006-100/BraTS-GLI-03006-100-t1c.nii.gz,../../DataSet/BraTS2024-BraTS-GLI-TrainingData/BraTS-GLI-03006-100/BraTS-GLI-03006-100-t2w.nii.gz,../../DataSet/BraTS2024-BraTS-GLI-TrainingData/BraTS-GLI-03006-100/BraTS-GLI-03006-100-t2f.nii.gz,../../DataSet/BraTS2024-BraTS-GLI-TrainingData/BraTS-GLI-03006-100/BraTS-GLI-03006-100-t1n.nii.gz,../../DataSet/BraTS2024-BraTS-GLI-TrainingData/BraTS-GLI-03006-100/BraTS-GLI-03006-100-seg.nii.gz,132,67,88,104,157,32,116,63,133,53,84,70
02063-101,../../DataSet/BraTS2024-BraTS-GLI-TrainingData/BraTS-GLI-02063-101/BraTS-GLI-02063-101-t1c.nii.gz,../../DataSet/BraTS2024-BraTS-GLI-TrainingData/BraTS-GLI-02063-101/BraTS-GLI-02063-101-t2w.nii.gz,../../DataSet/BraTS2024-BraTS-GLI-TrainingData/BraTS-GLI-02063-101/BraTS-GLI-02063-101-t2f.nii.gz,../../DataSet/BraTS2024-BraTS-GLI-TrainingData/BraTS-GLI-02063-101/BraTS-GLI-02063-101-t1n.nii.gz,../../DataSet/BraTS2024-BraTS-GLI-TrainingData/BraTS-GLI-02063-101/BraTS-GLI-02063-101-seg.nii.gz,51,98,109,26,76,62,145,74,144,50,83,70
02227-100,../../DataSet/BraTS2024-BraTS-GLI-TrainingData/BraTS-GLI-02227-100/BraTS-GLI-02227-100-t1c.nii.gz,../../DataSet/BraTS2024-BraTS-GLI-TrainingData/BraTS-GLI-02227-100/BraTS-GLI-02227-100-t2w.nii.gz,../../DataSet/BraTS2024-BraTS-GLI-TrainingData/BraTS-GLI-02227-100/BraTS-GLI-02227-100-t2f.nii.gz,../../DataSet/BraTS2024-BraTS-GLI-TrainingData/BraTS-GLI-02227-100/BraTS-GLI-02227-100-t1n.nii.gz,../../DataSet/BraTS2024-BraTS-GLI-TrainingData/BraTS-GLI-02227-100/BraTS-GLI-02227-100-seg.nii.gz,72,154,109,47,91,114,188,75,144,44,74,69
02870-101,../../DataSet/BraTS2024-BraTS-GLI-TrainingData/BraTS-GLI-02870-101/BraTS-GLI-02870-101-t1c.nii.gz,../../DataSet/BraTS2024-BraTS-GLI-TrainingData/BraTS-GLI-02870-101/BraTS-GLI-02870-101-t2w.nii.gz,../../DataSet/BraTS2024-BraTS-GLI-TrainingData/BraTS-GLI-02870-101/BraTS-GLI-02870-101-t2f.nii.gz,../../DataSet/BraTS2024-BraTS-GLI-TrainingData/BraTS-GLI-02870-101/BraTS-GLI-02870-101-t1n.nii.gz,../../DataSet/BraTS2024-BraTS-GLI-TrainingData/BraTS-GLI-02870-101/BraTS-GLI-02870-101-seg.nii.gz,100,132,111,58,140,82,176,65,141,82,94,76
02196-106,../../DataSet/BraTS2024-BraTS-GLI-TrainingData/BraTS-GLI-02196-106/BraTS-GLI-02196-106-t1c.nii.gz,../../DataSet/BraTS2024-BraTS-GLI-TrainingData/BraTS-GLI-02196-106/BraTS-GLI-02196-106-t2w.nii.gz,../../DataSet/BraTS2024-BraTS-GLI-TrainingData/BraTS-GLI-02196-106/BraTS-GLI-02196-106-t2f.nii.gz,../../DataSet/BraTS2024-BraTS-GLI-TrainingData/BraTS-GLI-02196-106/BraTS-GLI-02196-106-t1n.nii.gz,../../DataSet/BraTS2024-BraTS-GLI-TrainingData/BraTS-GLI-02196-106/BraTS-GLI-02196-106-seg.nii.gz,85,147,106,39,130,97,193,63,147,91,96,84
02778-101,../../DataSet/BraTS2024-BraTS-GLI-TrainingData/BraTS-GLI-02778-101/BraTS-GLI-02778-101-t1c.nii.gz,../../DataSet/BraTS2024-BraTS-GLI-TrainingData/BraTS-GLI-02778-101/BraTS-GLI-02778-101-t2w.nii.gz,../../DataSet/BraTS2024-BraTS-GLI-TrainingData/BraTS-GLI-02778-101/BraTS-GLI-02778-101-t2f.nii.gz,../../DataSet/BraTS2024-BraTS-GLI-TrainingData/BraTS-GLI-02778-101/BraTS-GLI-02778-101-t1n.nii.gz,../../DataSet/BraTS2024-BraTS-GLI-TrainingData/BraTS-GLI-02778-101/BraTS-GLI-02778-101-seg.nii.gz,52,106,88,23,95,61,153,38,131,72,92,93
02994-101,../../DataSet/BraTS2024-BraTS-GLI-TrainingData/BraTS-GLI-02994-101/BraTS-GLI-02994-101-t1c.nii.gz,../../DataSet/BraTS2024-BraTS-GLI-TrainingData/BraTS-GLI-02994-101/BraTS-GLI-02994-101-t2w.nii.gz,../../DataSet/BraTS2024-BraTS-GLI-TrainingData/BraTS-GLI-02994-101/BraTS-GLI-02994-101-t2f.nii.gz,../../DataSet/BraTS2024-BraTS-GLI-TrainingData/BraTS-GLI-02994-101/BraTS-GLI-02994-101-t1n.nii.gz,../../DataSet/BraTS2024-BraTS-GLI-TrainingData/BraTS-GLI-02994-101/BraTS-GLI-02994-101-seg.nii.gz,69,140,122,42,112,100,172,88,153,70,72,65
02241-101,../../DataSet/BraTS2024-BraTS-GLI-TrainingData/BraTS-GLI-02241-101/BraTS-GLI-02241-101-t1c.nii.gz,../../DataSet/BraTS2024-BraTS-GLI-TrainingData/BraTS-GLI-02241-101/BraTS-GLI-02241-101-t2w.nii.gz,../../DataSet/BraTS2024-BraTS-GLI-TrainingData/BraTS-GLI-02241-101/BraTS-GLI-02241-101-t2f.nii.gz,../../DataSet/BraTS2024-BraTS-GLI-TrainingData/BraTS-GLI-02241-101/BraTS-GLI-02241-101-t1n.nii.gz,../../DataSet/BraTS2024-BraTS-GLI-TrainingData/BraTS-GLI-02241-101/BraTS-GLI-02241-101-seg.nii.gz,109,157,94,87,139,116,196,57,133,52,80,76
02816-100,../../DataSet/BraTS2024-BraTS-GLI-TrainingData/BraTS-GLI-02816-100/BraTS-GLI-02816-100-t1c.nii.gz,../../DataSet/BraTS2024-BraTS-GLI-TrainingData/BraTS-GLI-02816-100/BraTS-GLI-02816-100-t2w.nii.gz,../../DataSet/BraTS2024-BraTS-GLI-TrainingData/BraTS-GLI-02816-100/BraTS-GLI-02816-100-t2f.nii.gz,../../DataSet/BraTS2024-BraTS-GLI-TrainingData/BraTS-GLI-02816-100/BraTS-GLI-02816-100-t1n.nii.gz,../../DataSet/BraTS2024-BraTS-GLI-TrainingData/BraTS-GLI-02816-100/BraTS-GLI-02816-100-seg.nii.gz,126,116,69,109,143,93,144,45,115,34,51,70
03060-101,../../DataSet/BraTS2024-BraTS-GLI-TrainingData/BraTS-GLI-03060-101/BraTS-GLI-03060-101-t1c.nii.gz,../../DataSet/BraTS2024-BraTS-GLI-TrainingData/BraTS-GLI-03060-101/BraTS-GLI-03060-101-t2w.nii.gz,../../DataSet/BraTS2024-BraTS-GLI-TrainingData/BraTS-GLI-03060-101/BraTS-GLI-03060-101-t2f.nii.gz,../../DataSet/BraTS2024-BraTS-GLI-TrainingData/BraTS-GLI-03060-101/BraTS-GLI-03060-101-t1n.nii.gz,../../DataSet/BraTS2024-BraTS-GLI-TrainingData/BraTS-GLI-03060-101/BraTS-GLI-03060-101-seg.nii.gz,53,81,110,33,77,53,117,82,139,44,64,57
02773-100,../../DataSet/BraTS2024-BraTS-GLI-TrainingData/BraTS-GLI-02773-100/BraTS-GLI-02773-100-t1c.nii.gz,../../DataSet/BraTS2024-BraTS-GLI-TrainingData/BraTS-GLI-02773-100/BraTS-GLI-02773-100-t2w.nii.gz,../../DataSet/BraTS2024-BraTS-GLI-TrainingData/BraTS-GLI-02773-100/BraTS-GLI-02773-100-t2f.nii.gz,../../DataSet/BraTS2024-BraTS-GLI-TrainingData/BraTS-GLI-02773-100/BraTS-GLI-02773-100-t1n.nii.gz,../../DataSet/BraTS2024-BraTS-GLI-TrainingData/BraTS-GLI-02773-100/BraTS-GLI-02773-100-seg.nii.gz,129,87,102,102,155,47,134,68,141,53,87,73
02290-101,../../DataSet/BraTS2024-BraTS-GLI-TrainingData/BraTS-GLI-02290-101/BraTS-GLI-02290-101-t1c.nii.gz,../../DataSet/BraTS2024-BraTS-GLI-TrainingData/BraTS-GLI-02290-101/BraTS-GLI-02290-101-t2w.nii.gz,../../DataSet/BraTS2024-BraTS-GLI-TrainingData/BraTS-GLI-02290-101/BraTS-GLI-02290-101-t2f.nii.gz,../../DataSet/BraTS2024-BraTS-GLI-TrainingData/BraTS-GLI-02290-101/BraTS-GLI-02290-101-t1n.nii.gz,../../DataSet/BraTS2024-BraTS-GLI-TrainingData/BraTS-GLI-02290-101/BraTS-GLI-02290-101-seg.nii.gz,97,115,121,67,124,73,158,89,155,57,85,66
03017-100,../../DataSet/BraTS2024-BraTS-GLI-TrainingData/BraTS-GLI-03017-100/BraTS-GLI-03017-100-t1c.nii.gz,../../DataSet/BraTS2024-BraTS-GLI-TrainingData/BraTS-GLI-03017-100/BraTS-GLI-03017-100-t2w.nii.gz,../../DataSet/BraTS2024-BraTS-GLI-TrainingData/BraTS-GLI-03017-100/BraTS-GLI-03017-100-t2f.nii.gz,../../DataSet/BraTS2024-BraTS-GLI-TrainingData/BraTS-GLI-03017-100/BraTS-GLI-03017-100-t1n.nii.gz,../../DataSet/BraTS2024-BraTS-GLI-TrainingData/BraTS-GLI-03017-100/BraTS-GLI-03017-100-seg.nii.gz,106,105,117,72,136,62,139,92,147,64,77,55
02657-100,../../DataSet/BraTS2024-BraTS-GLI-TrainingData/BraTS-GLI-02657-100/BraTS-GLI-02657-100-t1c.nii.gz,../../DataSet/BraTS2024-BraTS-GLI-TrainingData/BraTS-GLI-02657-100/BraTS-GLI-02657-100-t2w.nii.gz,../../DataSet/BraTS2024-BraTS-GLI-TrainingData/BraTS-GLI-02657-100/BraTS-GLI-02657-100-t2f.nii.gz,../../DataSet/BraTS2024-BraTS-GLI-TrainingData/BraTS-GLI-02657-100/BraTS-GLI-02657-100-t1n.nii.gz,../../DataSet/BraTS2024-BraTS-GLI-TrainingData/BraTS-GLI-02657-100/BraTS-GLI-02657-100-seg.nii.gz,60,78,117,41,82,55,101,95,145,41,46,50
02072-101,../../DataSet/BraTS2024-BraTS-GLI-TrainingData/BraTS-GLI-02072-101/BraTS-GLI-02072-101-t1c.nii.gz,../../DataSet/BraTS2024-BraTS-GLI-TrainingData/BraTS-GLI-02072-101/BraTS-GLI-02072-101-t2w.nii.gz,../../DataSet/BraTS2024-BraTS-GLI-TrainingData/BraTS-GLI-02072-101/BraTS-GLI-02072-101-t2f.nii.gz,../../DataSet/BraTS2024-BraTS-GLI-TrainingData/BraTS-GLI-02072-101/BraTS-GLI-02072-101-t1n.nii.gz,../../DataSet/BraTS2024-BraTS-GLI-TrainingData/BraTS-GLI-02072-101/BraTS-GLI-02072-101-seg.nii.gz,54,95,82,37,77,64,130,54,119,40,66,65
02236-100,../../DataSet/BraTS2024-BraTS-GLI-TrainingData/BraTS-GLI-02236-100/BraTS-GLI-02236-100-t1c.nii.gz,../../DataSet/BraTS2024-BraTS-GLI-TrainingData/BraTS-GLI-02236-100/BraTS-GLI-02236-100-t2w.nii.gz,../../DataSet/BraTS2024-BraTS-GLI-TrainingData/BraTS-GLI-02236-100/BraTS-GLI-02236-100-t2f.nii.gz,../../DataSet/BraTS2024-BraTS-GLI-TrainingData/BraTS-GLI-02236-100/BraTS-GLI-02236-100-t1n.nii.gz,../../DataSet/BraTS2024-BraTS-GLI-TrainingData/BraTS-GLI-02236-100/BraTS-GLI-02236-100-seg.nii.gz,137,138,86,133,142,133,144,83,91,9,11,8
02861-101,../../DataSet/BraTS2024-BraTS-GLI-TrainingData/BraTS-GLI-02861-101/BraTS-GLI-02861-101-t1c.nii.gz,../../DataSet/BraTS2024-BraTS-GLI-TrainingData/BraTS-GLI-02861-101/BraTS-GLI-02861-101-t2w.nii.gz,../../DataSet/BraTS2024-BraTS-GLI-TrainingData/BraTS-GLI-02861-101/BraTS-GLI-02861-101-t2f.nii.gz,../../DataSet/BraTS2024-BraTS-GLI-TrainingData/BraTS-GLI-02861-101/BraTS-GLI-02861-101-t1n.nii.gz,../../DataSet/BraTS2024-BraTS-GLI-TrainingData/BraTS-GLI-02861-101/BraTS-GLI-02861-101-seg.nii.gz,118,80,113,107,132,73,87,105,132,25,14,27
02932-100,../../DataSet/BraTS2024-BraTS-GLI-TrainingData/BraTS-GLI-02932-100/BraTS-GLI-02932-100-t1c.nii.gz,../../DataSet/BraTS2024-BraTS-GLI-TrainingData/BraTS-GLI-02932-100/BraTS-GLI-02932-100-t2w.nii.gz,../../DataSet/BraTS2024-BraTS-GLI-TrainingData/BraTS-GLI-02932-100/BraTS-GLI-02932-100-t2f.nii.gz,../../DataSet/BraTS2024-BraTS-GLI-TrainingData/BraTS-GLI-02932-100/BraTS-GLI-02932-100-t1n.nii.gz,../../DataSet/BraTS2024-BraTS-GLI-TrainingData/BraTS-GLI-02932-100/BraTS-GLI-02932-100-seg.nii.gz,55,53,102,31,77,35,74,77,125,46,39,48
02205-103,../../DataSet/BraTS2024-BraTS-GLI-TrainingData/BraTS-GLI-02205-103/BraTS-GLI-02205-103-t1c.nii.gz,../../DataSet/BraTS2024-BraTS-GLI-TrainingData/BraTS-GLI-02205-103/BraTS-GLI-02205-103-t2w.nii.gz,../../DataSet/BraTS2024-BraTS-GLI-TrainingData/BraTS-GLI-02205-103/BraTS-GLI-02205-103-t2f.nii.gz,../../DataSet/BraTS2024-BraTS-GLI-TrainingData/BraTS-GLI-02205-103/BraTS-GLI-02205-103-t1n.nii.gz,../../DataSet/BraTS2024-BraTS-GLI-TrainingData/BraTS-GLI-02205-103/BraTS-GLI-02205-103-seg.nii.gz,103,142,116,90,126,109,178,78,152,36,69,74
02112-103,../../DataSet/BraTS2024-BraTS-GLI-TrainingData/BraTS-GLI-02112-103/BraTS-GLI-02112-103-t1c.nii.gz,../../DataSet/BraTS2024-BraTS-GLI-TrainingData/BraTS-GLI-02112-103/BraTS-GLI-02112-103-t2w.nii.gz,../../DataSet/BraTS2024-BraTS-GLI-TrainingData/BraTS-GLI-02112-103/BraTS-GLI-02112-103-t2f.nii.gz,../../DataSet/BraTS2024-BraTS-GLI-TrainingData/BraTS-GLI-02112-103/BraTS-GLI-02112-103-t1n.nii.gz,../../DataSet/BraTS2024-BraTS-GLI-TrainingData/BraTS-GLI-02112-103/BraTS-GLI-02112-103-seg.nii.gz,64,68,115,40,116,32,122,74,153,76,90,79
02939-101,../../DataSet/BraTS2024-BraTS-GLI-TrainingData/BraTS-GLI-02939-101/BraTS-GLI-02939-101-t1c.nii.gz,../../DataSet/BraTS2024-BraTS-GLI-TrainingData/BraTS-GLI-02939-101/BraTS-GLI-02939-101-t2w.nii.gz,../../DataSet/BraTS2024-BraTS-GLI-TrainingData/BraTS-GLI-02939-101/BraTS-GLI-02939-101-t2f.nii.gz,../../DataSet/BraTS2024-BraTS-GLI-TrainingData/BraTS-GLI-02939-101/BraTS-GLI-02939-101-t1n.nii.gz,../../DataSet/BraTS2024-BraTS-GLI-TrainingData/BraTS-GLI-02939-101/BraTS-GLI-02939-101-seg.nii.gz,126,58,85,82,150,35,115,67,111,68,80,44
02866-101,../../DataSet/BraTS2024-BraTS-GLI-TrainingData/BraTS-GLI-02866-101/BraTS-GLI-02866-101-t1c.nii.gz,../../DataSet/BraTS2024-BraTS-GLI-TrainingData/BraTS-GLI-02866-101/BraTS-GLI-02866-101-t2w.nii.gz,../../DataSet/BraTS2024-BraTS-GLI-TrainingData/BraTS-GLI-02866-101/BraTS-GLI-02866-101-t2f.nii.gz,../../DataSet/BraTS2024-BraTS-GLI-TrainingData/BraTS-GLI-02866-101/BraTS-GLI-02866-101-t1n.nii.gz,../../DataSet/BraTS2024-BraTS-GLI-TrainingData/BraTS-GLI-02866-101/BraTS-GLI-02866-101-seg.nii.gz,123,128,63,102,157,87,154,42,91,55,67,49
02209-102,../../DataSet/BraTS2024-BraTS-GLI-TrainingData/BraTS-GLI-02209-102/BraTS-GLI-02209-102-t1c.nii.gz,../../DataSet/BraTS2024-BraTS-GLI-TrainingData/BraTS-GLI-02209-102/BraTS-GLI-02209-102-t2w.nii.gz,../../DataSet/BraTS2024-BraTS-GLI-TrainingData/BraTS-GLI-02209-102/BraTS-GLI-02209-102-t2f.nii.gz,../../DataSet/BraTS2024-BraTS-GLI-TrainingData/BraTS-GLI-02209-102/BraTS-GLI-02209-102-t1n.nii.gz,../../DataSet/BraTS2024-BraTS-GLI-TrainingData/BraTS-GLI-02209-102/BraTS-GLI-02209-102-seg.nii.gz,62,131,97,32,119,96,168,47,143,87,72,96
02547-100,../../DataSet/BraTS2024-BraTS-GLI-TrainingData/BraTS-GLI-02547-100/BraTS-GLI-02547-100-t1c.nii.gz,../../DataSet/BraTS2024-BraTS-GLI-TrainingData/BraTS-GLI-02547-100/BraTS-GLI-02547-100-t2w.nii.gz,../../DataSet/BraTS2024-BraTS-GLI-TrainingData/BraTS-GLI-02547-100/BraTS-GLI-02547-100-t2f.nii.gz,../../DataSet/BraTS2024-BraTS-GLI-TrainingData/BraTS-GLI-02547-100/BraTS-GLI-02547-100-t1n.nii.gz,../../DataSet/BraTS2024-BraTS-GLI-TrainingData/BraTS-GLI-02547-100/BraTS-GLI-02547-100-seg.nii.gz,80,83,122,68,94,68,102,100,147,26,34,47
02708-100,../../DataSet/BraTS2024-BraTS-GLI-TrainingData/BraTS-GLI-02708-100/BraTS-GLI-02708-100-t1c.nii.gz,../../DataSet/BraTS2024-BraTS-GLI-TrainingData/BraTS-GLI-02708-100/BraTS-GLI-02708-100-t2w.nii.gz,../../DataSet/BraTS2024-BraTS-GLI-TrainingData/BraTS-GLI-02708-100/BraTS-GLI-02708-100-t2f.nii.gz,../../DataSet/BraTS2024-BraTS-GLI-TrainingData/BraTS-GLI-02708-100/BraTS-GLI-02708-100-t1n.nii.gz,../../DataSet/BraTS2024-BraTS-GLI-TrainingData/BraTS-GLI-02708-100/BraTS-GLI-02708-100-seg.nii.gz,78,157,74,49,111,116,186,36,108,62,70,72
02369-100,../../DataSet/BraTS2024-BraTS-GLI-TrainingData/BraTS-GLI-02369-100/BraTS-GLI-02369-100-t1c.nii.gz,../../DataSet/BraTS2024-BraTS-GLI-TrainingData/BraTS-GLI-02369-100/BraTS-GLI-02369-100-t2w.nii.gz,../../DataSet/BraTS2024-BraTS-GLI-TrainingData/BraTS-GLI-02369-100/BraTS-GLI-02369-100-t2f.nii.gz,../../DataSet/BraTS2024-BraTS-GLI-TrainingData/BraTS-GLI-02369-100/BraTS-GLI-02369-100-t1n.nii.gz,../../DataSet/BraTS2024-BraTS-GLI-TrainingData/BraTS-GLI-02369-100/BraTS-GLI-02369-100-seg.nii.gz,48,119,68,21,78,73,157,52,85,57,84,33
00518-100,../../DataSet/BraTS2024-BraTS-GLI-TrainingData/BraTS-GLI-00518-100/BraTS-GLI-00518-100-t1c.nii.gz,../../DataSet/BraTS2024-BraTS-GLI-TrainingData/BraTS-GLI-00518-100/BraTS-GLI-00518-100-t2w.nii.gz,../../DataSet/BraTS2024-BraTS-GLI-TrainingData/BraTS-GLI-00518-100/BraTS-GLI-00518-100-t2f.nii.gz,../../DataSet/BraTS2024-BraTS-GLI-TrainingData/BraTS-GLI-00518-100/BraTS-GLI-00518-100-t1n.nii.gz,../../DataSet/BraTS2024-BraTS-GLI-TrainingData/BraTS-GLI-00518-100/BraTS-GLI-00518-100-seg.nii.gz,125,133,98,105,141,110,152,82,112,36,42,30
02949-100,../../DataSet/BraTS2024-BraTS-GLI-TrainingData/BraTS-GLI-02949-100/BraTS-GLI-02949-100-t1c.nii.gz,../../DataSet/BraTS2024-BraTS-GLI-TrainingData/BraTS-GLI-02949-100/BraTS-GLI-02949-100-t2w.nii.gz,../../DataSet/BraTS2024-BraTS-GLI-TrainingData/BraTS-GLI-02949-100/BraTS-GLI-02949-100-t2f.nii.gz,../../DataSet/BraTS2024-BraTS-GLI-TrainingData/BraTS-GLI-02949-100/BraTS-GLI-02949-100-t1n.nii.gz,../../DataSet/BraTS2024-BraTS-GLI-TrainingData/BraTS-GLI-02949-100/BraTS-GLI-02949-100-seg.nii.gz,51,69,107,22,90,44,107,71,135,68,63,64
02246-101,../../DataSet/BraTS2024-BraTS-GLI-TrainingData/BraTS-GLI-02246-101/BraTS-GLI-02246-101-t1c.nii.gz,../../DataSet/BraTS2024-BraTS-GLI-TrainingData/BraTS-GLI-02246-101/BraTS-GLI-02246-101-t2w.nii.gz,../../DataSet/BraTS2024-BraTS-GLI-TrainingData/BraTS-GLI-02246-101/BraTS-GLI-02246-101-t2f.nii.gz,../../DataSet/BraTS2024-BraTS-GLI-TrainingData/BraTS-GLI-02246-101/BraTS-GLI-02246-101-t1n.nii.gz,../../DataSet/BraTS2024-BraTS-GLI-TrainingData/BraTS-GLI-02246-101/BraTS-GLI-02246-101-seg.nii.gz,62,130,67,48,88,107,152,49,84,40,45,35
02993-101,../../DataSet/BraTS2024-BraTS-GLI-TrainingData/BraTS-GLI-02993-101/BraTS-GLI-02993-101-t1c.nii.gz,../../DataSet/BraTS2024-BraTS-GLI-TrainingData/BraTS-GLI-02993-101/BraTS-GLI-02993-101-t2w.nii.gz,../../DataSet/BraTS2024-BraTS-GLI-TrainingData/BraTS-GLI-02993-101/BraTS-GLI-02993-101-t2f.nii.gz,../../DataSet/BraTS2024-BraTS-GLI-TrainingData/BraTS-GLI-02993-101/BraTS-GLI-02993-101-t1n.nii.gz,../../DataSet/BraTS2024-BraTS-GLI-TrainingData/BraTS-GLI-02993-101/BraTS-GLI-02993-101-seg.nii.gz,55,131,94,39,76,116,150,81,108,37,34,27
02315-100,../../DataSet/BraTS2024-BraTS-GLI-TrainingData/BraTS-GLI-02315-100/BraTS-GLI-02315-100-t1c.nii.gz,../../DataSet/BraTS2024-BraTS-GLI-TrainingData/BraTS-GLI-02315-100/BraTS-GLI-02315-100-t2w.nii.gz,../../DataSet/BraTS2024-BraTS-GLI-TrainingData/BraTS-GLI-02315-100/BraTS-GLI-02315-100-t2f.nii.gz,../../DataSet/BraTS2024-BraTS-GLI-TrainingData/BraTS-GLI-02315-100/BraTS-GLI-02315-100-t1n.nii.gz,../../DataSet/BraTS2024-BraTS-GLI-TrainingData/BraTS-GLI-02315-100/BraTS-GLI-02315-100-seg.nii.gz,64,62,63,28,123,28,115,36,93,95,87,57
02868-101,../../DataSet/BraTS2024-BraTS-GLI-TrainingData/BraTS-GLI-02868-101/BraTS-GLI-02868-101-t1c.nii.gz,../../DataSet/BraTS2024-BraTS-GLI-TrainingData/BraTS-GLI-02868-101/BraTS-GLI-02868-101-t2w.nii.gz,../../DataSet/BraTS2024-BraTS-GLI-TrainingData/BraTS-GLI-02868-101/BraTS-GLI-02868-101-t2f.nii.gz,../../DataSet/BraTS2024-BraTS-GLI-TrainingData/BraTS-GLI-02868-101/BraTS-GLI-02868-101-t1n.nii.gz,../../DataSet/BraTS2024-BraTS-GLI-TrainingData/BraTS-GLI-02868-101/BraTS-GLI-02868-101-seg.nii.gz,116,47,94,94,138,15,102,72,122,44,87,50
02128-100,../../DataSet/BraTS2024-BraTS-GLI-TrainingData/BraTS-GLI-02128-100/BraTS-GLI-02128-100-t1c.nii.gz,../../DataSet/BraTS2024-BraTS-GLI-TrainingData/BraTS-GLI-02128-100/BraTS-GLI-02128-100-t2w.nii.gz,../../DataSet/BraTS2024-BraTS-GLI-TrainingData/BraTS-GLI-02128-100/BraTS-GLI-02128-100-t2f.nii.gz,../../DataSet/BraTS2024-BraTS-GLI-TrainingData/BraTS-GLI-02128-100/BraTS-GLI-02128-100-t1n.nii.gz,../../DataSet/BraTS2024-BraTS-GLI-TrainingData/BraTS-GLI-02128-100/BraTS-GLI-02128-100-seg.nii.gz,76,84,122,44,133,51,123,88,157,89,72,69
02092-103,../../DataSet/BraTS2024-BraTS-GLI-TrainingData/BraTS-GLI-02092-103/BraTS-GLI-02092-103-t1c.nii.gz,../../DataSet/BraTS2024-BraTS-GLI-TrainingData/BraTS-GLI-02092-103/BraTS-GLI-02092-103-t2w.nii.gz,../../DataSet/BraTS2024-BraTS-GLI-TrainingData/BraTS-GLI-02092-103/BraTS-GLI-02092-103-t2f.nii.gz,../../DataSet/BraTS2024-BraTS-GLI-TrainingData/BraTS-GLI-02092-103/BraTS-GLI-02092-103-t1n.nii.gz,../../DataSet/BraTS2024-BraTS-GLI-TrainingData/BraTS-GLI-02092-103/BraTS-GLI-02092-103-seg.nii.gz,95,158,98,57,124,108,194,64,135,67,86,71
02863-100,../../DataSet/BraTS2024-BraTS-GLI-TrainingData/BraTS-GLI-02863-100/BraTS-GLI-02863-100-t1c.nii.gz,../../DataSet/BraTS2024-BraTS-GLI-TrainingData/BraTS-GLI-02863-100/BraTS-GLI-02863-100-t2w.nii.gz,../../DataSet/BraTS2024-BraTS-GLI-TrainingData/BraTS-GLI-02863-100/BraTS-GLI-02863-100-t2f.nii.gz,../../DataSet/BraTS2024-BraTS-GLI-TrainingData/BraTS-GLI-02863-100/BraTS-GLI-02863-100-t1n.nii.gz,../../DataSet/BraTS2024-BraTS-GLI-TrainingData/BraTS-GLI-02863-100/BraTS-GLI-02863-100-seg.nii.gz,50,63,71,26,80,30,100,48,107,54,70,59
03015-101,../../DataSet/BraTS2024-BraTS-GLI-TrainingData/BraTS-GLI-03015-101/BraTS-GLI-03015-101-t1c.nii.gz,../../DataSet/BraTS2024-BraTS-GLI-TrainingData/BraTS-GLI-03015-101/BraTS-GLI-03015-101-t2w.nii.gz,../../DataSet/BraTS2024-BraTS-GLI-TrainingData/BraTS-GLI-03015-101/BraTS-GLI-03015-101-t2f.nii.gz,../../DataSet/BraTS2024-BraTS-GLI-TrainingData/BraTS-GLI-03015-101/BraTS-GLI-03015-101-t1n.nii.gz,../../DataSet/BraTS2024-BraTS-GLI-TrainingData/BraTS-GLI-03015-101/BraTS-GLI-03015-101-seg.nii.gz,43,74,68,24,71,33,117,47,115,47,84,68
03062-100,../../DataSet/BraTS2024-BraTS-GLI-TrainingData/BraTS-GLI-03062-100/BraTS-GLI-03062-100-t1c.nii.gz,../../DataSet/BraTS2024-BraTS-GLI-TrainingData/BraTS-GLI-03062-100/BraTS-GLI-03062-100-t2w.nii.gz,../../DataSet/BraTS2024-BraTS-GLI-TrainingData/BraTS-GLI-03062-100/BraTS-GLI-03062-100-t2f.nii.gz,../../DataSet/BraTS2024-BraTS-GLI-TrainingData/BraTS-GLI-03062-100/BraTS-GLI-03062-100-t1n.nii.gz,../../DataSet/BraTS2024-BraTS-GLI-TrainingData/BraTS-GLI-03062-100/BraTS-GLI-03062-100-seg.nii.gz,109,91,92,80,135,41,123,62,122,55,82,60
02243-100,../../DataSet/BraTS2024-BraTS-GLI-TrainingData/BraTS-GLI-02243-100/BraTS-GLI-02243-100-t1c.nii.gz,../../DataSet/BraTS2024-BraTS-GLI-TrainingData/BraTS-GLI-02243-100/BraTS-GLI-02243-100-t2w.nii.gz,../../DataSet/BraTS2024-BraTS-GLI-TrainingData/BraTS-GLI-02243-100/BraTS-GLI-02243-100-t2f.nii.gz,../../DataSet/BraTS2024-BraTS-GLI-TrainingData/BraTS-GLI-02243-100/BraTS-GLI-02243-100-t1n.nii.gz,../../DataSet/BraTS2024-BraTS-GLI-TrainingData/BraTS-GLI-02243-100/BraTS-GLI-02243-100-seg.nii.gz,75,119,128,59,89,93,146,102,152,30,53,50
02248-101,../../DataSet/BraTS2024-BraTS-GLI-TrainingData/BraTS-GLI-02248-101/BraTS-GLI-02248-101-t1c.nii.gz,../../DataSet/BraTS2024-BraTS-GLI-TrainingData/BraTS-GLI-02248-101/BraTS-GLI-02248-101-t2w.nii.gz,../../DataSet/BraTS2024-BraTS-GLI-TrainingData/BraTS-GLI-02248-101/BraTS-GLI-02248-101-t2f.nii.gz,../../DataSet/BraTS2024-BraTS-GLI-TrainingData/BraTS-GLI-02248-101/BraTS-GLI-02248-101-t1n.nii.gz,../../DataSet/BraTS2024-BraTS-GLI-TrainingData/BraTS-GLI-02248-101/BraTS-GLI-02248-101-seg.nii.gz,103,83,103,63,127,56,115,74,134,64,59,60
02625-100,../../DataSet/BraTS2024-BraTS-GLI-TrainingData/BraTS-GLI-02625-100/BraTS-GLI-02625-100-t1c.nii.gz,../../DataSet/BraTS2024-BraTS-GLI-TrainingData/BraTS-GLI-02625-100/BraTS-GLI-02625-100-t2w.nii.gz,../../DataSet/BraTS2024-BraTS-GLI-TrainingData/BraTS-GLI-02625-100/BraTS-GLI-02625-100-t2f.nii.gz,../../DataSet/BraTS2024-BraTS-GLI-TrainingData/BraTS-GLI-02625-100/BraTS-GLI-02625-100-t1n.nii.gz,../../DataSet/BraTS2024-BraTS-GLI-TrainingData/BraTS-GLI-02625-100/BraTS-GLI-02625-100-seg.nii.gz,42,81,53,37,48,76,88,51,57,11,12,6
02813-101,../../DataSet/BraTS2024-BraTS-GLI-TrainingData/BraTS-GLI-02813-101/BraTS-GLI-02813-101-t1c.nii.gz,../../DataSet/BraTS2024-BraTS-GLI-TrainingData/BraTS-GLI-02813-101/BraTS-GLI-02813-101-t2w.nii.gz,../../DataSet/BraTS2024-BraTS-GLI-TrainingData/BraTS-GLI-02813-101/BraTS-GLI-02813-101-t2f.nii.gz,../../DataSet/BraTS2024-BraTS-GLI-TrainingData/BraTS-GLI-02813-101/BraTS-GLI-02813-101-t1n.nii.gz,../../DataSet/BraTS2024-BraTS-GLI-TrainingData/BraTS-GLI-02813-101/BraTS-GLI-02813-101-seg.nii.gz,107,133,122,65,144,90,179,82,157,79,89,75
02244-100,../../DataSet/BraTS2024-BraTS-GLI-TrainingData/BraTS-GLI-02244-100/BraTS-GLI-02244-100-t1c.nii.gz,../../DataSet/BraTS2024-BraTS-GLI-TrainingData/BraTS-GLI-02244-100/BraTS-GLI-02244-100-t2w.nii.gz,../../DataSet/BraTS2024-BraTS-GLI-TrainingData/BraTS-GLI-02244-100/BraTS-GLI-02244-100-t2f.nii.gz,../../DataSet/BraTS2024-BraTS-GLI-TrainingData/BraTS-GLI-02244-100/BraTS-GLI-02244-100-t1n.nii.gz,../../DataSet/BraTS2024-BraTS-GLI-TrainingData/BraTS-GLI-02244-100/BraTS-GLI-02244-100-seg.nii.gz,73,145,101,52,91,115,177,59,143,39,62,84
00511-100,../../DataSet/BraTS2024-BraTS-GLI-TrainingData/BraTS-GLI-00511-100/BraTS-GLI-00511-100-t1c.nii.gz,../../DataSet/BraTS2024-BraTS-GLI-TrainingData/BraTS-GLI-00511-100/BraTS-GLI-00511-100-t2w.nii.gz,../../DataSet/BraTS2024-BraTS-GLI-TrainingData/BraTS-GLI-00511-100/BraTS-GLI-00511-100-t2f.nii.gz,../../DataSet/BraTS2024-BraTS-GLI-TrainingData/BraTS-GLI-00511-100/BraTS-GLI-00511-100-t1n.nii.gz,../../DataSet/BraTS2024-BraTS-GLI-TrainingData/BraTS-GLI-00511-100/BraTS-GLI-00511-100-seg.nii.gz,129,135,60,107,147,112,155,39,87,40,43,48
02153-100,../../DataSet/BraTS2024-BraTS-GLI-TrainingData/BraTS-GLI-02153-100/BraTS-GLI-02153-100-t1c.nii.gz,../../DataSet/BraTS2024-BraTS-GLI-TrainingData/BraTS-GLI-02153-100/BraTS-GLI-02153-100-t2w.nii.gz,../../DataSet/BraTS2024-BraTS-GLI-TrainingData/BraTS-GLI-02153-100/BraTS-GLI-02153-100-t2f.nii.gz,../../DataSet/BraTS2024-BraTS-GLI-TrainingData/BraTS-GLI-02153-100/BraTS-GLI-02153-100-t1n.nii.gz,../../DataSet/BraTS2024-BraTS-GLI-TrainingData/BraTS-GLI-02153-100/BraTS-GLI-02153-100-seg.nii.gz,133,114,57,106,156,81,136,42,77,50,55,35
02776-101,../../DataSet/BraTS2024-BraTS-GLI-TrainingData/BraTS-GLI-02776-101/BraTS-GLI-02776-101-t1c.nii.gz,../../DataSet/BraTS2024-BraTS-GLI-TrainingData/BraTS-GLI-02776-101/BraTS-GLI-02776-101-t2w.nii.gz,../../DataSet/BraTS2024-BraTS-GLI-TrainingData/BraTS-GLI-02776-101/BraTS-GLI-02776-101-t2f.nii.gz,../../DataSet/BraTS2024-BraTS-GLI-TrainingData/BraTS-GLI-02776-101/BraTS-GLI-02776-101-t1n.nii.gz,../../DataSet/BraTS2024-BraTS-GLI-TrainingData/BraTS-GLI-02776-101/BraTS-GLI-02776-101-seg.nii.gz,115,108,120,98,140,74,150,93,142,42,76,49
02818-100,../../DataSet/BraTS2024-BraTS-GLI-TrainingData/BraTS-GLI-02818-100/BraTS-GLI-02818-100-t1c.nii.gz,../../DataSet/BraTS2024-BraTS-GLI-TrainingData/BraTS-GLI-02818-100/BraTS-GLI-02818-100-t2w.nii.gz,../../DataSet/BraTS2024-BraTS-GLI-TrainingData/BraTS-GLI-02818-100/BraTS-GLI-02818-100-t2f.nii.gz,../../DataSet/BraTS2024-BraTS-GLI-TrainingData/BraTS-GLI-02818-100/BraTS-GLI-02818-100-t1n.nii.gz,../../DataSet/BraTS2024-BraTS-GLI-TrainingData/BraTS-GLI-02818-100/BraTS-GLI-02818-100-seg.nii.gz,119,146,70,89,148,102,194,41,94,59,92,53
00498-100,../../DataSet/BraTS2024-BraTS-GLI-TrainingData/BraTS-GLI-00498-100/BraTS-GLI-00498-100-t1c.nii.gz,../../DataSet/BraTS2024-BraTS-GLI-TrainingData/BraTS-GLI-00498-100/BraTS-GLI-00498-100-t2w.nii.gz,../../DataSet/BraTS2024-BraTS-GLI-TrainingData/BraTS-GLI-00498-100/BraTS-GLI-00498-100-t2f.nii.gz,../../DataSet/BraTS2024-BraTS-GLI-TrainingData/BraTS-GLI-00498-100/BraTS-GLI-00498-100-t1n.nii.gz,../../DataSet/BraTS2024-BraTS-GLI-TrainingData/BraTS-GLI-00498-100/BraTS-GLI-00498-100-seg.nii.gz,133,117,70,85,153,65,151,30,95,68,86,65
02659-100,../../DataSet/BraTS2024-BraTS-GLI-TrainingData/BraTS-GLI-02659-100/BraTS-GLI-02659-100-t1c.nii.gz,../../DataSet/BraTS2024-BraTS-GLI-TrainingData/BraTS-GLI-02659-100/BraTS-GLI-02659-100-t2w.nii.gz,../../DataSet/BraTS2024-BraTS-GLI-TrainingData/BraTS-GLI-02659-100/BraTS-GLI-02659-100-t2f.nii.gz,../../DataSet/BraTS2024-BraTS-GLI-TrainingData/BraTS-GLI-02659-100/BraTS-GLI-02659-100-t1n.nii.gz,../../DataSet/BraTS2024-BraTS-GLI-TrainingData/BraTS-GLI-02659-100/BraTS-GLI-02659-100-seg.nii.gz,54,161,81,34,77,139,190,54,109,43,51,55
02238-100,../../DataSet/BraTS2024-BraTS-GLI-TrainingData/BraTS-GLI-02238-100/BraTS-GLI-02238-100-t1c.nii.gz,../../DataSet/BraTS2024-BraTS-GLI-TrainingData/BraTS-GLI-02238-100/BraTS-GLI-02238-100-t2w.nii.gz,../../DataSet/BraTS2024-BraTS-GLI-TrainingData/BraTS-GLI-02238-100/BraTS-GLI-02238-100-t2f.nii.gz,../../DataSet/BraTS2024-BraTS-GLI-TrainingData/BraTS-GLI-02238-100/BraTS-GLI-02238-100-t1n.nii.gz,../../DataSet/BraTS2024-BraTS-GLI-TrainingData/BraTS-GLI-02238-100/BraTS-GLI-02238-100-seg.nii.gz,76,167,100,60,91,141,195,75,130,31,54,55
02688-100,../../DataSet/BraTS2024-BraTS-GLI-TrainingData/BraTS-GLI-02688-100/BraTS-GLI-02688-100-t1c.nii.gz,../../DataSet/BraTS2024-BraTS-GLI-TrainingData/BraTS-GLI-02688-100/BraTS-GLI-02688-100-t2w.nii.gz,../../DataSet/BraTS2024-BraTS-GLI-TrainingData/BraTS-GLI-02688-100/BraTS-GLI-02688-100-t2f.nii.gz,../../DataSet/BraTS2024-BraTS-GLI-TrainingData/BraTS-GLI-02688-100/BraTS-GLI-02688-100-t1n.nii.gz,../../DataSet/BraTS2024-BraTS-GLI-TrainingData/BraTS-GLI-02688-100/BraTS-GLI-02688-100-seg.nii.gz,106,148,124,91,121,128,175,92,145,30,47,53
00085-100,../../DataSet/BraTS2024-BraTS-GLI-TrainingData/BraTS-GLI-00085-100/BraTS-GLI-00085-100-t1c.nii.gz,../../DataSet/BraTS2024-BraTS-GLI-TrainingData/BraTS-GLI-00085-100/BraTS-GLI-00085-100-t2w.nii.gz,../../DataSet/BraTS2024-BraTS-GLI-TrainingData/BraTS-GLI-00085-100/BraTS-GLI-00085-100-t2f.nii.gz,../../DataSet/BraTS2024-BraTS-GLI-TrainingData/BraTS-GLI-00085-100/BraTS-GLI-00085-100-t1n.nii.gz,../../DataSet/BraTS2024-BraTS-GLI-TrainingData/BraTS-GLI-00085-100/BraTS-GLI-00085-100-seg.nii.gz,108,62,115,68,128,35,93,76,143,60,58,67
02124-101,../../DataSet/BraTS2024-BraTS-GLI-TrainingData/BraTS-GLI-02124-101/BraTS-GLI-02124-101-t1c.nii.gz,../../DataSet/BraTS2024-BraTS-GLI-TrainingData/BraTS-GLI-02124-101/BraTS-GLI-02124-101-t2w.nii.gz,../../DataSet/BraTS2024-BraTS-GLI-TrainingData/BraTS-GLI-02124-101/BraTS-GLI-02124-101-t2f.nii.gz,../../DataSet/BraTS2024-BraTS-GLI-TrainingData/BraTS-GLI-02124-101/BraTS-GLI-02124-101-t1n.nii.gz,../../DataSet/BraTS2024-BraTS-GLI-TrainingData/BraTS-GLI-02124-101/BraTS-GLI-02124-101-seg.nii.gz,53,116,64,31,82,78,147,38,92,51,69,54
02701-100,../../DataSet/BraTS2024-BraTS-GLI-TrainingData/BraTS-GLI-02701-100/BraTS-GLI-02701-100-t1c.nii.gz,../../DataSet/BraTS2024-BraTS-GLI-TrainingData/BraTS-GLI-02701-100/BraTS-GLI-02701-100-t2w.nii.gz,../../DataSet/BraTS2024-BraTS-GLI-TrainingData/BraTS-GLI-02701-100/BraTS-GLI-02701-100-t2f.nii.gz,../../DataSet/BraTS2024-BraTS-GLI-TrainingData/BraTS-GLI-02701-100/BraTS-GLI-02701-100-t1n.nii.gz,../../DataSet/BraTS2024-BraTS-GLI-TrainingData/BraTS-GLI-02701-100/BraTS-GLI-02701-100-seg.nii.gz,112,165,104,91,134,135,194,75,135,43,59,60
02937-101,../../DataSet/BraTS2024-BraTS-GLI-TrainingData/BraTS-GLI-02937-101/BraTS-GLI-02937-101-t1c.nii.gz,../../DataSet/BraTS2024-BraTS-GLI-TrainingData/BraTS-GLI-02937-101/BraTS-GLI-02937-101-t2w.nii.gz,../../DataSet/BraTS2024-BraTS-GLI-TrainingData/BraTS-GLI-02937-101/BraTS-GLI-02937-101-t2f.nii.gz,../../DataSet/BraTS2024-BraTS-GLI-TrainingData/BraTS-GLI-02937-101/BraTS-GLI-02937-101-t1n.nii.gz,../../DataSet/BraTS2024-BraTS-GLI-TrainingData/BraTS-GLI-02937-101/BraTS-GLI-02937-101-seg.nii.gz,97,95,106,56,129,52,141,72,139,73,89,67
02360-100,../../DataSet/BraTS2024-BraTS-GLI-TrainingData/BraTS-GLI-02360-100/BraTS-GLI-02360-100-t1c.nii.gz,../../DataSet/BraTS2024-BraTS-GLI-TrainingData/BraTS-GLI-02360-100/BraTS-GLI-02360-100-t2w.nii.gz,../../DataSet/BraTS2024-BraTS-GLI-TrainingData/BraTS-GLI-02360-100/BraTS-GLI-02360-100-t2f.nii.gz,../../DataSet/BraTS2024-BraTS-GLI-TrainingData/BraTS-GLI-02360-100/BraTS-GLI-02360-100-t1n.nii.gz,../../DataSet/BraTS2024-BraTS-GLI-TrainingData/BraTS-GLI-02360-100/BraTS-GLI-02360-100-seg.nii.gz,51,117,98,30,79,66,159,56,133,49,93,77
02166-100,../../DataSet/BraTS2024-BraTS-GLI-TrainingData/BraTS-GLI-02166-100/BraTS-GLI-02166-100-t1c.nii.gz,../../DataSet/BraTS2024-BraTS-GLI-TrainingData/BraTS-GLI-02166-100/BraTS-GLI-02166-100-t2w.nii.gz,../../DataSet/BraTS2024-BraTS-GLI-TrainingData/BraTS-GLI-02166-100/BraTS-GLI-02166-100-t2f.nii.gz,../../DataSet/BraTS2024-BraTS-GLI-TrainingData/BraTS-GLI-02166-100/BraTS-GLI-02166-100-t1n.nii.gz,../../DataSet/BraTS2024-BraTS-GLI-TrainingData/BraTS-GLI-02166-100/BraTS-GLI-02166-100-seg.nii.gz,109,58,90,90,134,36,88,66,119,44,52,53
02271-100,../../DataSet/BraTS2024-BraTS-GLI-TrainingData/BraTS-GLI-02271-100/BraTS-GLI-02271-100-t1c.nii.gz,../../DataSet/BraTS2024-BraTS-GLI-TrainingData/BraTS-GLI-02271-100/BraTS-GLI-02271-100-t2w.nii.gz,../../DataSet/BraTS2024-BraTS-GLI-TrainingData/BraTS-GLI-02271-100/BraTS-GLI-02271-100-t2f.nii.gz,../../DataSet/BraTS2024-BraTS-GLI-TrainingData/BraTS-GLI-02271-100/BraTS-GLI-02271-100-t1n.nii.gz,../../DataSet/BraTS2024-BraTS-GLI-TrainingData/BraTS-GLI-02271-100/BraTS-GLI-02271-100-seg.nii.gz,126,75,64,105,148,46,99,49,86,43,53,37
02610-100,../../DataSet/BraTS2024-BraTS-GLI-TrainingData/BraTS-GLI-02610-100/BraTS-GLI-02610-100-t1c.nii.gz,../../DataSet/BraTS2024-BraTS-GLI-TrainingData/BraTS-GLI-02610-100/BraTS-GLI-02610-100-t2w.nii.gz,../../DataSet/BraTS2024-BraTS-GLI-TrainingData/BraTS-GLI-02610-100/BraTS-GLI-02610-100-t2f.nii.gz,../../DataSet/BraTS2024-BraTS-GLI-TrainingData/BraTS-GLI-02610-100/BraTS-GLI-02610-100-t1n.nii.gz,../../DataSet/BraTS2024-BraTS-GLI-TrainingData/BraTS-GLI-02610-100/BraTS-GLI-02610-100-seg.nii.gz,117,91,91,91,149,41,136,59,128,58,95,69
03050-100,../../DataSet/BraTS2024-BraTS-GLI-TrainingData/BraTS-GLI-03050-100/BraTS-GLI-03050-100-t1c.nii.gz,../../DataSet/BraTS2024-BraTS-GLI-TrainingData/BraTS-GLI-03050-100/BraTS-GLI-03050-100-t2w.nii.gz,../../DataSet/BraTS2024-BraTS-GLI-TrainingData/BraTS-GLI-03050-100/BraTS-GLI-03050-100-t2f.nii.gz,../../DataSet/BraTS2024-BraTS-GLI-TrainingData/BraTS-GLI-03050-100/BraTS-GLI-03050-100-t1n.nii.gz,../../DataSet/BraTS2024-BraTS-GLI-TrainingData/BraTS-GLI-03050-100/BraTS-GLI-03050-100-seg.nii.gz,112,72,106,75,158,32,120,67,149,83,88,82
02329-100,../../DataSet/BraTS2024-BraTS-GLI-TrainingData/BraTS-GLI-02329-100/BraTS-GLI-02329-100-t1c.nii.gz,../../DataSet/BraTS2024-BraTS-GLI-TrainingData/BraTS-GLI-02329-100/BraTS-GLI-02329-100-t2w.nii.gz,../../DataSet/BraTS2024-BraTS-GLI-TrainingData/BraTS-GLI-02329-100/BraTS-GLI-02329-100-t2f.nii.gz,../../DataSet/BraTS2024-BraTS-GLI-TrainingData/BraTS-GLI-02329-100/BraTS-GLI-02329-100-t1n.nii.gz,../../DataSet/BraTS2024-BraTS-GLI-TrainingData/BraTS-GLI-02329-100/BraTS-GLI-02329-100-seg.nii.gz,76,162,125,64,91,145,184,110,142,27,39,32
02748-100,../../DataSet/BraTS2024-BraTS-GLI-TrainingData/BraTS-GLI-02748-100/BraTS-GLI-02748-100-t1c.nii.gz,../../DataSet/BraTS2024-BraTS-GLI-TrainingData/BraTS-GLI-02748-100/BraTS-GLI-02748-100-t2w.nii.gz,../../DataSet/BraTS2024-BraTS-GLI-TrainingData/BraTS-GLI-02748-100/BraTS-GLI-02748-100-t2f.nii.gz,../../DataSet/BraTS2024-BraTS-GLI-TrainingData/BraTS-GLI-02748-100/BraTS-GLI-02748-100-t1n.nii.gz,../../DataSet/BraTS2024-BraTS-GLI-TrainingData/BraTS-GLI-02748-100/BraTS-GLI-02748-100-seg.nii.gz,121,127,87,98,140,84,166,56,118,42,82,62
02799-100,../../DataSet/BraTS2024-BraTS-GLI-TrainingData/BraTS-GLI-02799-100/BraTS-GLI-02799-100-t1c.nii.gz,../../DataSet/BraTS2024-BraTS-GLI-TrainingData/BraTS-GLI-02799-100/BraTS-GLI-02799-100-t2w.nii.gz,../../DataSet/BraTS2024-BraTS-GLI-TrainingData/BraTS-GLI-02799-100/BraTS-GLI-02799-100-t2f.nii.gz,../../DataSet/BraTS2024-BraTS-GLI-TrainingData/BraTS-GLI-02799-100/BraTS-GLI-02799-100-t1n.nii.gz,../../DataSet/BraTS2024-BraTS-GLI-TrainingData/BraTS-GLI-02799-100/BraTS-GLI-02799-100-seg.nii.gz,128,110,72,98,155,68,146,49,97,57,78,48
02355-100,../../DataSet/BraTS2024-BraTS-GLI-TrainingData/BraTS-GLI-02355-100/BraTS-GLI-02355-100-t1c.nii.gz,../../DataSet/BraTS2024-BraTS-GLI-TrainingData/BraTS-GLI-02355-100/BraTS-GLI-02355-100-t2w.nii.gz,../../DataSet/BraTS2024-BraTS-GLI-TrainingData/BraTS-GLI-02355-100/BraTS-GLI-02355-100-t2f.nii.gz,../../DataSet/BraTS2024-BraTS-GLI-TrainingData/BraTS-GLI-02355-100/BraTS-GLI-02355-100-t1n.nii.gz,../../DataSet/BraTS2024-BraTS-GLI-TrainingData/BraTS-GLI-02355-100/BraTS-GLI-02355-100-seg.nii.gz,57,103,104,23,90,56,148,63,149,67,92,86
02902-101,../../DataSet/BraTS2024-BraTS-GLI-TrainingData/BraTS-GLI-02902-101/BraTS-GLI-02902-101-t1c.nii.gz,../../DataSet/BraTS2024-BraTS-GLI-TrainingData/BraTS-GLI-02902-101/BraTS-GLI-02902-101-t2w.nii.gz,../../DataSet/BraTS2024-BraTS-GLI-TrainingData/BraTS-GLI-02902-101/BraTS-GLI-02902-101-t2f.nii.gz,../../DataSet/BraTS2024-BraTS-GLI-TrainingData/BraTS-GLI-02902-101/BraTS-GLI-02902-101-t1n.nii.gz,../../DataSet/BraTS2024-BraTS-GLI-TrainingData/BraTS-GLI-02902-101/BraTS-GLI-02902-101-seg.nii.gz,125,118,113,99,152,83,151,88,146,53,68,58
02111-101,../../DataSet/BraTS2024-BraTS-GLI-TrainingData/BraTS-GLI-02111-101/BraTS-GLI-02111-101-t1c.nii.gz,../../DataSet/BraTS2024-BraTS-GLI-TrainingData/BraTS-GLI-02111-101/BraTS-GLI-02111-101-t2w.nii.gz,../../DataSet/BraTS2024-BraTS-GLI-TrainingData/BraTS-GLI-02111-101/BraTS-GLI-02111-101-t2f.nii.gz,../../DataSet/BraTS2024-BraTS-GLI-TrainingData/BraTS-GLI-02111-101/BraTS-GLI-02111-101-t1n.nii.gz,../../DataSet/BraTS2024-BraTS-GLI-TrainingData/BraTS-GLI-02111-101/BraTS-GLI-02111-101-seg.nii.gz,73,76,114,52,118,50,113,85,151,66,63,66
02093-100,../../DataSet/BraTS2024-BraTS-GLI-TrainingData/BraTS-GLI-02093-100/BraTS-GLI-02093-100-t1c.nii.gz,../../DataSet/BraTS2024-BraTS-GLI-TrainingData/BraTS-GLI-02093-100/BraTS-GLI-02093-100-t2w.nii.gz,../../DataSet/BraTS2024-BraTS-GLI-TrainingData/BraTS-GLI-02093-100/BraTS-GLI-02093-100-t2f.nii.gz,../../DataSet/BraTS2024-BraTS-GLI-TrainingData/BraTS-GLI-02093-100/BraTS-GLI-02093-100-t1n.nii.gz,../../DataSet/BraTS2024-BraTS-GLI-TrainingData/BraTS-GLI-02093-100/BraTS-GLI-02093-100-seg.nii.gz,107,172,90,69,134,118,202,49,139,65,84,90
02851-100,../../DataSet/BraTS2024-BraTS-GLI-TrainingData/BraTS-GLI-02851-100/BraTS-GLI-02851-100-t1c.nii.gz,../../DataSet/BraTS2024-BraTS-GLI-TrainingData/BraTS-GLI-02851-100/BraTS-GLI-02851-100-t2w.nii.gz,../../DataSet/BraTS2024-BraTS-GLI-TrainingData/BraTS-GLI-02851-100/BraTS-GLI-02851-100-t2f.nii.gz,../../DataSet/BraTS2024-BraTS-GLI-TrainingData/BraTS-GLI-02851-100/BraTS-GLI-02851-100-t1n.nii.gz,../../DataSet/BraTS2024-BraTS-GLI-TrainingData/BraTS-GLI-02851-100/BraTS-GLI-02851-100-seg.nii.gz,82,71,129,65,115,48,99,88,155,50,51,67
02887-100,../../DataSet/BraTS2024-BraTS-GLI-TrainingData/BraTS-GLI-02887-100/BraTS-GLI-02887-100-t1c.nii.gz,../../DataSet/BraTS2024-BraTS-GLI-TrainingData/BraTS-GLI-02887-100/BraTS-GLI-02887-100-t2w.nii.gz,../../DataSet/BraTS2024-BraTS-GLI-TrainingData/BraTS-GLI-02887-100/BraTS-GLI-02887-100-t2f.nii.gz,../../DataSet/BraTS2024-BraTS-GLI-TrainingData/BraTS-GLI-02887-100/BraTS-GLI-02887-100-t1n.nii.gz,../../DataSet/BraTS2024-BraTS-GLI-TrainingData/BraTS-GLI-02887-100/BraTS-GLI-02887-100-seg.nii.gz,51,60,79,34,70,37,93,62,109,36,56,47
02352-100,../../DataSet/BraTS2024-BraTS-GLI-TrainingData/BraTS-GLI-02352-100/BraTS-GLI-02352-100-t1c.nii.gz,../../DataSet/BraTS2024-BraTS-GLI-TrainingData/BraTS-GLI-02352-100/BraTS-GLI-02352-100-t2w.nii.gz,../../DataSet/BraTS2024-BraTS-GLI-TrainingData/BraTS-GLI-02352-100/BraTS-GLI-02352-100-t2f.nii.gz,../../DataSet/BraTS2024-BraTS-GLI-TrainingData/BraTS-GLI-02352-100/BraTS-GLI-02352-100-t1n.nii.gz,../../DataSet/BraTS2024-BraTS-GLI-TrainingData/BraTS-GLI-02352-100/BraTS-GLI-02352-100-seg.nii.gz,69,121,76,37,133,77,157,38,113,96,80,75
02116-101,../../DataSet/BraTS2024-BraTS-GLI-TrainingData/BraTS-GLI-02116-101/BraTS-GLI-02116-101-t1c.nii.gz,../../DataSet/BraTS2024-BraTS-GLI-TrainingData/BraTS-GLI-02116-101/BraTS-GLI-02116-101-t2w.nii.gz,../../DataSet/BraTS2024-BraTS-GLI-TrainingData/BraTS-GLI-02116-101/BraTS-GLI-02116-101-t2f.nii.gz,../../DataSet/BraTS2024-BraTS-GLI-TrainingData/BraTS-GLI-02116-101/BraTS-GLI-02116-101-t1n.nii.gz,../../DataSet/BraTS2024-BraTS-GLI-TrainingData/BraTS-GLI-02116-101/BraTS-GLI-02116-101-seg.nii.gz,52,116,100,23,99,73,168,59,140,76,95,81
03020-101,../../DataSet/BraTS2024-BraTS-GLI-TrainingData/BraTS-GLI-03020-101/BraTS-GLI-03020-101-t1c.nii.gz,../../DataSet/BraTS2024-BraTS-GLI-TrainingData/BraTS-GLI-03020-101/BraTS-GLI-03020-101-t2w.nii.gz,../../DataSet/BraTS2024-BraTS-GLI-TrainingData/BraTS-GLI-03020-101/BraTS-GLI-03020-101-t2f.nii.gz,../../DataSet/BraTS2024-BraTS-GLI-TrainingData/BraTS-GLI-03020-101/BraTS-GLI-03020-101-t1n.nii.gz,../../DataSet/BraTS2024-BraTS-GLI-TrainingData/BraTS-GLI-03020-101/BraTS-GLI-03020-101-seg.nii.gz,58,90,101,30,86,48,140,67,137,56,92,70
02856-100,../../DataSet/BraTS2024-BraTS-GLI-TrainingData/BraTS-GLI-02856-100/BraTS-GLI-02856-100-t1c.nii.gz,../../DataSet/BraTS2024-BraTS-GLI-TrainingData/BraTS-GLI-02856-100/BraTS-GLI-02856-100-t2w.nii.gz,../../DataSet/BraTS2024-BraTS-GLI-TrainingData/BraTS-GLI-02856-100/BraTS-GLI-02856-100-t2f.nii.gz,../../DataSet/BraTS2024-BraTS-GLI-TrainingData/BraTS-GLI-02856-100/BraTS-GLI-02856-100-t1n.nii.gz,../../DataSet/BraTS2024-BraTS-GLI-TrainingData/BraTS-GLI-02856-100/BraTS-GLI-02856-100-seg.nii.gz,129,102,96,110,153,76,133,80,113,43,57,33
02239-103,../../DataSet/BraTS2024-BraTS-GLI-TrainingData/BraTS-GLI-02239-103/BraTS-GLI-02239-103-t1c.nii.gz,../../DataSet/BraTS2024-BraTS-GLI-TrainingData/BraTS-GLI-02239-103/BraTS-GLI-02239-103-t2w.nii.gz,../../DataSet/BraTS2024-BraTS-GLI-TrainingData/BraTS-GLI-02239-103/BraTS-GLI-02239-103-t2f.nii.gz,../../DataSet/BraTS2024-BraTS-GLI-TrainingData/BraTS-GLI-02239-103/BraTS-GLI-02239-103-t1n.nii.gz,../../DataSet/BraTS2024-BraTS-GLI-TrainingData/BraTS-GLI-02239-103/BraTS-GLI-02239-103-seg.nii.gz,52,128,52,33,76,108,150,39,72,43,42,33
02821-101,../../DataSet/BraTS2024-BraTS-GLI-TrainingData/BraTS-GLI-02821-101/BraTS-GLI-02821-101-t1c.nii.gz,../../DataSet/BraTS2024-BraTS-GLI-TrainingData/BraTS-GLI-02821-101/BraTS-GLI-02821-101-t2w.nii.gz,../../DataSet/BraTS2024-BraTS-GLI-TrainingData/BraTS-GLI-02821-101/BraTS-GLI-02821-101-t2f.nii.gz,../../DataSet/BraTS2024-BraTS-GLI-TrainingData/BraTS-GLI-02821-101/BraTS-GLI-02821-101-t1n.nii.gz,../../DataSet/BraTS2024-BraTS-GLI-TrainingData/BraTS-GLI-02821-101/BraTS-GLI-02821-101-seg.nii.gz,121,60,99,99,148,27,98,61,134,49,71,73
02795-101,../../DataSet/BraTS2024-BraTS-GLI-TrainingData/BraTS-GLI-02795-101/BraTS-GLI-02795-101-t1c.nii.gz,../../DataSet/BraTS2024-BraTS-GLI-TrainingData/BraTS-GLI-02795-101/BraTS-GLI-02795-101-t2w.nii.gz,../../DataSet/BraTS2024-BraTS-GLI-TrainingData/BraTS-GLI-02795-101/BraTS-GLI-02795-101-t2f.nii.gz,../../DataSet/BraTS2024-BraTS-GLI-TrainingData/BraTS-GLI-02795-101/BraTS-GLI-02795-101-t1n.nii.gz,../../DataSet/BraTS2024-BraTS-GLI-TrainingData/BraTS-GLI-02795-101/BraTS-GLI-02795-101-seg.nii.gz,72,63,113,44,106,19,107,75,146,62,88,71
02152-103,../../DataSet/BraTS2024-BraTS-GLI-TrainingData/BraTS-GLI-02152-103/BraTS-GLI-02152-103-t1c.nii.gz,../../DataSet/BraTS2024-BraTS-GLI-TrainingData/BraTS-GLI-02152-103/BraTS-GLI-02152-103-t2w.nii.gz,../../DataSet/BraTS2024-BraTS-GLI-TrainingData/BraTS-GLI-02152-103/BraTS-GLI-02152-103-t2f.nii.gz,../../DataSet/BraTS2024-BraTS-GLI-TrainingData/BraTS-GLI-02152-103/BraTS-GLI-02152-103-t1n.nii.gz,../../DataSet/BraTS2024-BraTS-GLI-TrainingData/BraTS-GLI-02152-103/BraTS-GLI-02152-103-seg.nii.gz,61,82,94,40,84,43,128,61,124,44,85,63
02245-103,../../DataSet/BraTS2024-BraTS-GLI-TrainingData/BraTS-GLI-02245-103/BraTS-GLI-02245-103-t1c.nii.gz,../../DataSet/BraTS2024-BraTS-GLI-TrainingData/BraTS-GLI-02245-103/BraTS-GLI-02245-103-t2w.nii.gz,../../DataSet/BraTS2024-BraTS-GLI-TrainingData/BraTS-GLI-02245-103/BraTS-GLI-02245-103-t2f.nii.gz,../../DataSet/BraTS2024-BraTS-GLI-TrainingData/BraTS-GLI-02245-103/BraTS-GLI-02245-103-t1n.nii.gz,../../DataSet/BraTS2024-BraTS-GLI-TrainingData/BraTS-GLI-02245-103/BraTS-GLI-02245-103-seg.nii.gz,79,135,123,58,94,96,171,85,155,36,75,70
02736-101,../../DataSet/BraTS2024-BraTS-GLI-TrainingData/BraTS-GLI-02736-101/BraTS-GLI-02736-101-t1c.nii.gz,../../DataSet/BraTS2024-BraTS-GLI-TrainingData/BraTS-GLI-02736-101/BraTS-GLI-02736-101-t2w.nii.gz,../../DataSet/BraTS2024-BraTS-GLI-TrainingData/BraTS-GLI-02736-101/BraTS-GLI-02736-101-t2f.nii.gz,../../DataSet/BraTS2024-BraTS-GLI-TrainingData/BraTS-GLI-02736-101/BraTS-GLI-02736-101-t1n.nii.gz,../../DataSet/BraTS2024-BraTS-GLI-TrainingData/BraTS-GLI-02736-101/BraTS-GLI-02736-101-seg.nii.gz,71,129,96,51,86,115,145,86,118,35,30,32
02062-105,../../DataSet/BraTS2024-BraTS-GLI-TrainingData/BraTS-GLI-02062-105/BraTS-GLI-02062-105-t1c.nii.gz,../../DataSet/BraTS2024-BraTS-GLI-TrainingData/BraTS-GLI-02062-105/BraTS-GLI-02062-105-t2w.nii.gz,../../DataSet/BraTS2024-BraTS-GLI-TrainingData/BraTS-GLI-02062-105/BraTS-GLI-02062-105-t2f.nii.gz,../../DataSet/BraTS2024-BraTS-GLI-TrainingData/BraTS-GLI-02062-105/BraTS-GLI-02062-105-t1n.nii.gz,../../DataSet/BraTS2024-BraTS-GLI-TrainingData/BraTS-GLI-02062-105/BraTS-GLI-02062-105-seg.nii.gz,62,83,105,30,94,45,114,64,146,64,69,82
02882-101,../../DataSet/BraTS2024-BraTS-GLI-TrainingData/BraTS-GLI-02882-101/BraTS-GLI-02882-101-t1c.nii.gz,../../DataSet/BraTS2024-BraTS-GLI-TrainingData/BraTS-GLI-02882-101/BraTS-GLI-02882-101-t2w.nii.gz,../../DataSet/BraTS2024-BraTS-GLI-TrainingData/BraTS-GLI-02882-101/BraTS-GLI-02882-101-t2f.nii.gz,../../DataSet/BraTS2024-BraTS-GLI-TrainingData/BraTS-GLI-02882-101/BraTS-GLI-02882-101-t1n.nii.gz,../../DataSet/BraTS2024-BraTS-GLI-TrainingData/BraTS-GLI-02882-101/BraTS-GLI-02882-101-seg.nii.gz,86,157,107,50,125,95,190,80,140,75,95,60
02204-100,../../DataSet/BraTS2024-BraTS-GLI-TrainingData/BraTS-GLI-02204-100/BraTS-GLI-02204-100-t1c.nii.gz,../../DataSet/BraTS2024-BraTS-GLI-TrainingData/BraTS-GLI-02204-100/BraTS-GLI-02204-100-t2w.nii.gz,../../DataSet/BraTS2024-BraTS-GLI-TrainingData/BraTS-GLI-02204-100/BraTS-GLI-02204-100-t2f.nii.gz,../../DataSet/BraTS2024-BraTS-GLI-TrainingData/BraTS-GLI-02204-100/BraTS-GLI-02204-100-t1n.nii.gz,../../DataSet/BraTS2024-BraTS-GLI-TrainingData/BraTS-GLI-02204-100/BraTS-GLI-02204-100-seg.nii.gz,68,130,70,45,97,100,158,47,94,52,58,47
02665-100,../../DataSet/BraTS2024-BraTS-GLI-TrainingData/BraTS-GLI-02665-100/BraTS-GLI-02665-100-t1c.nii.gz,../../DataSet/BraTS2024-BraTS-GLI-TrainingData/BraTS-GLI-02665-100/BraTS-GLI-02665-100-t2w.nii.gz,../../DataSet/BraTS2024-BraTS-GLI-TrainingData/BraTS-GLI-02665-100/BraTS-GLI-02665-100-t2f.nii.gz,../../DataSet/BraTS2024-BraTS-GLI-TrainingData/BraTS-GLI-02665-100/BraTS-GLI-02665-100-t1n.nii.gz,../../DataSet/BraTS2024-BraTS-GLI-TrainingData/BraTS-GLI-02665-100/BraTS-GLI-02665-100-seg.nii.gz,107,167,99,71,133,134,196,64,139,62,62,75
03025-100,../../DataSet/BraTS2024-BraTS-GLI-TrainingData/BraTS-GLI-03025-100/BraTS-GLI-03025-100-t1c.nii.gz,../../DataSet/BraTS2024-BraTS-GLI-TrainingData/BraTS-GLI-03025-100/BraTS-GLI-03025-100-t2w.nii.gz,../../DataSet/BraTS2024-BraTS-GLI-TrainingData/BraTS-GLI-03025-100/BraTS-GLI-03025-100-t2f.nii.gz,../../DataSet/BraTS2024-BraTS-GLI-TrainingData/BraTS-GLI-03025-100/BraTS-GLI-03025-100-t1n.nii.gz,../../DataSet/BraTS2024-BraTS-GLI-TrainingData/BraTS-GLI-03025-100/BraTS-GLI-03025-100-seg.nii.gz,76,110,131,64,89,93,130,108,148,25,37,40
02889-100,../../DataSet/BraTS2024-BraTS-GLI-TrainingData/BraTS-GLI-02889-100/BraTS-GLI-02889-100-t1c.nii.gz,../../DataSet/BraTS2024-BraTS-GLI-TrainingData/BraTS-GLI-02889-100/BraTS-GLI-02889-100-t2w.nii.gz,../../DataSet/BraTS2024-BraTS-GLI-TrainingData/BraTS-GLI-02889-100/BraTS-GLI-02889-100-t2f.nii.gz,../../DataSet/BraTS2024-BraTS-GLI-TrainingData/BraTS-GLI-02889-100/BraTS-GLI-02889-100-t1n.nii.gz,../../DataSet/BraTS2024-BraTS-GLI-TrainingData/BraTS-GLI-02889-100/BraTS-GLI-02889-100-seg.nii.gz,120,138,119,105,141,116,156,98,142,36,40,44
02858-100,../../DataSet/BraTS2024-BraTS-GLI-TrainingData/BraTS-GLI-02858-100/BraTS-GLI-02858-100-t1c.nii.gz,../../DataSet/BraTS2024-BraTS-GLI-TrainingData/BraTS-GLI-02858-100/BraTS-GLI-02858-100-t2w.nii.gz,../../DataSet/BraTS2024-BraTS-GLI-TrainingData/BraTS-GLI-02858-100/BraTS-GLI-02858-100-t2f.nii.gz,../../DataSet/BraTS2024-BraTS-GLI-TrainingData/BraTS-GLI-02858-100/BraTS-GLI-02858-100-t1n.nii.gz,../../DataSet/BraTS2024-BraTS-GLI-TrainingData/BraTS-GLI-02858-100/BraTS-GLI-02858-100-seg.nii.gz,126,79,99,108,145,57,101,82,120,37,44,38
03059-100,../../DataSet/BraTS2024-BraTS-GLI-TrainingData/BraTS-GLI-03059-100/BraTS-GLI-03059-100-t1c.nii.gz,../../DataSet/BraTS2024-BraTS-GLI-TrainingData/BraTS-GLI-03059-100/BraTS-GLI-03059-100-t2w.nii.gz,../../DataSet/BraTS2024-BraTS-GLI-TrainingData/BraTS-GLI-03059-100/BraTS-GLI-03059-100-t2f.nii.gz,../../DataSet/BraTS2024-BraTS-GLI-TrainingData/BraTS-GLI-03059-100/BraTS-GLI-03059-100-t1n.nii.gz,../../DataSet/BraTS2024-BraTS-GLI-TrainingData/BraTS-GLI-03059-100/BraTS-GLI-03059-100-seg.nii.gz,128,89,71,98,155,42,135,38,107,57,93,69
02977-101,../../DataSet/BraTS2024-BraTS-GLI-TrainingData/BraTS-GLI-02977-101/BraTS-GLI-02977-101-t1c.nii.gz,../../DataSet/BraTS2024-BraTS-GLI-TrainingData/BraTS-GLI-02977-101/BraTS-GLI-02977-101-t2w.nii.gz,../../DataSet/BraTS2024-BraTS-GLI-TrainingData/BraTS-GLI-02977-101/BraTS-GLI-02977-101-t2f.nii.gz,../../DataSet/BraTS2024-BraTS-GLI-TrainingData/BraTS-GLI-02977-101/BraTS-GLI-02977-101-t1n.nii.gz,../../DataSet/BraTS2024-BraTS-GLI-TrainingData/BraTS-GLI-02977-101/BraTS-GLI-02977-101-seg.nii.gz,51,133,89,35,74,100,163,65,119,39,63,54
02164-101,../../DataSet/BraTS2024-BraTS-GLI-TrainingData/BraTS-GLI-02164-101/BraTS-GLI-02164-101-t1c.nii.gz,../../DataSet/BraTS2024-BraTS-GLI-TrainingData/BraTS-GLI-02164-101/BraTS-GLI-02164-101-t2w.nii.gz,../../DataSet/BraTS2024-BraTS-GLI-TrainingData/BraTS-GLI-02164-101/BraTS-GLI-02164-101-t2f.nii.gz,../../DataSet/BraTS2024-BraTS-GLI-TrainingData/BraTS-GLI-02164-101/BraTS-GLI-02164-101-t1n.nii.gz,../../DataSet/BraTS2024-BraTS-GLI-TrainingData/BraTS-GLI-02164-101/BraTS-GLI-02164-101-seg.nii.gz,129,76,112,106,150,50,119,81,138,44,69,57
02741-100,../../DataSet/BraTS2024-BraTS-GLI-TrainingData/BraTS-GLI-02741-100/BraTS-GLI-02741-100-t1c.nii.gz,../../DataSet/BraTS2024-BraTS-GLI-TrainingData/BraTS-GLI-02741-100/BraTS-GLI-02741-100-t2w.nii.gz,../../DataSet/BraTS2024-BraTS-GLI-TrainingData/BraTS-GLI-02741-100/BraTS-GLI-02741-100-t2f.nii.gz,../../DataSet/BraTS2024-BraTS-GLI-TrainingData/BraTS-GLI-02741-100/BraTS-GLI-02741-100-t1n.nii.gz,../../DataSet/BraTS2024-BraTS-GLI-TrainingData/BraTS-GLI-02741-100/BraTS-GLI-02741-100-seg.nii.gz,84,69,84,77,91,58,83,75,95,14,25,20
03052-101,../../DataSet/BraTS2024-BraTS-GLI-TrainingData/BraTS-GLI-03052-101/BraTS-GLI-03052-101-t1c.nii.gz,../../DataSet/BraTS2024-BraTS-GLI-TrainingData/BraTS-GLI-03052-101/BraTS-GLI-03052-101-t2w.nii.gz,../../DataSet/BraTS2024-BraTS-GLI-TrainingData/BraTS-GLI-03052-101/BraTS-GLI-03052-101-t2f.nii.gz,../../DataSet/BraTS2024-BraTS-GLI-TrainingData/BraTS-GLI-03052-101/BraTS-GLI-03052-101-t1n.nii.gz,../../DataSet/BraTS2024-BraTS-GLI-TrainingData/BraTS-GLI-03052-101/BraTS-GLI-03052-101-seg.nii.gz,93,144,100,63,141,110,169,80,119,78,59,39
02824-100,../../DataSet/BraTS2024-BraTS-GLI-TrainingData/BraTS-GLI-02824-100/BraTS-GLI-02824-100-t1c.nii.gz,../../DataSet/BraTS2024-BraTS-GLI-TrainingData/BraTS-GLI-02824-100/BraTS-GLI-02824-100-t2w.nii.gz,../../DataSet/BraTS2024-BraTS-GLI-TrainingData/BraTS-GLI-02824-100/BraTS-GLI-02824-100-t2f.nii.gz,../../DataSet/BraTS2024-BraTS-GLI-TrainingData/BraTS-GLI-02824-100/BraTS-GLI-02824-100-t1n.nii.gz,../../DataSet/BraTS2024-BraTS-GLI-TrainingData/BraTS-GLI-02824-100/BraTS-GLI-02824-100-seg.nii.gz,61,122,80,33,120,74,169,50,127,87,95,77
02247-102,../../DataSet/BraTS2024-BraTS-GLI-TrainingData/BraTS-GLI-02247-102/BraTS-GLI-02247-102-t1c.nii.gz,../../DataSet/BraTS2024-BraTS-GLI-TrainingData/BraTS-GLI-02247-102/BraTS-GLI-02247-102-t2w.nii.gz,../../DataSet/BraTS2024-BraTS-GLI-TrainingData/BraTS-GLI-02247-102/BraTS-GLI-02247-102-t2f.nii.gz,../../DataSet/BraTS2024-BraTS-GLI-TrainingData/BraTS-GLI-02247-102/BraTS-GLI-02247-102-t1n.nii.gz,../../DataSet/BraTS2024-BraTS-GLI-TrainingData/BraTS-GLI-02247-102/BraTS-GLI-02247-102-seg.nii.gz,45,117,98,31,62,92,142,72,130,31,50,58
02181-102,../../DataSet/BraTS2024-BraTS-GLI-TrainingData/BraTS-GLI-02181-102/BraTS-GLI-02181-102-t1c.nii.gz,../../DataSet/BraTS2024-BraTS-GLI-TrainingData/BraTS-GLI-02181-102/BraTS-GLI-02181-102-t2w.nii.gz,../../DataSet/BraTS2024-BraTS-GLI-TrainingData/BraTS-GLI-02181-102/BraTS-GLI-02181-102-t2f.nii.gz,../../DataSet/BraTS2024-BraTS-GLI-TrainingData/BraTS-GLI-02181-102/BraTS-GLI-02181-102-t1n.nii.gz,../../DataSet/BraTS2024-BraTS-GLI-TrainingData/BraTS-GLI-02181-102/BraTS-GLI-02181-102-seg.nii.gz,130,125,91,109,151,74,166,58,129,42,92,71
02970-101,../../DataSet/BraTS2024-BraTS-GLI-TrainingData/BraTS-GLI-02970-101/BraTS-GLI-02970-101-t1c.nii.gz,../../DataSet/BraTS2024-BraTS-GLI-TrainingData/BraTS-GLI-02970-101/BraTS-GLI-02970-101-t2w.nii.gz,../../DataSet/BraTS2024-BraTS-GLI-TrainingData/BraTS-GLI-02970-101/BraTS-GLI-02970-101-t2f.nii.gz,../../DataSet/BraTS2024-BraTS-GLI-TrainingData/BraTS-GLI-02970-101/BraTS-GLI-02970-101-t1n.nii.gz,../../DataSet/BraTS2024-BraTS-GLI-TrainingData/BraTS-GLI-02970-101/BraTS-GLI-02970-101-seg.nii.gz,69,163,101,37,115,127,201,74,132,78,74,58
02327-100,../../DataSet/BraTS2024-BraTS-GLI-TrainingData/BraTS-GLI-02327-100/BraTS-GLI-02327-100-t1c.nii.gz,../../DataSet/BraTS2024-BraTS-GLI-TrainingData/BraTS-GLI-02327-100/BraTS-GLI-02327-100-t2w.nii.gz,../../DataSet/BraTS2024-BraTS-GLI-TrainingData/BraTS-GLI-02327-100/BraTS-GLI-02327-100-t2f.nii.gz,../../DataSet/BraTS2024-BraTS-GLI-TrainingData/BraTS-GLI-02327-100/BraTS-GLI-02327-100-t1n.nii.gz,../../DataSet/BraTS2024-BraTS-GLI-TrainingData/BraTS-GLI-02327-100/BraTS-GLI-02327-100-seg.nii.gz,58,84,103,36,101,59,111,79,130,65,52,51
00472-100,../../DataSet/BraTS2024-BraTS-GLI-TrainingData/BraTS-GLI-00472-100/BraTS-GLI-00472-100-t1c.nii.gz,../../DataSet/BraTS2024-BraTS-GLI-TrainingData/BraTS-GLI-00472-100/BraTS-GLI-00472-100-t2w.nii.gz,../../DataSet/BraTS2024-BraTS-GLI-TrainingData/BraTS-GLI-00472-100/BraTS-GLI-00472-100-t2f.nii.gz,../../DataSet/BraTS2024-BraTS-GLI-TrainingData/BraTS-GLI-00472-100/BraTS-GLI-00472-100-t1n.nii.gz,../../DataSet/BraTS2024-BraTS-GLI-TrainingData/BraTS-GLI-00472-100/BraTS-GLI-00472-100-seg.nii.gz,129,120,54,109,149,94,145,40,77,40,51,37
02746-100,../../DataSet/BraTS2024-BraTS-GLI-TrainingData/BraTS-GLI-02746-100/BraTS-GLI-02746-100-t1c.nii.gz,../../DataSet/BraTS2024-BraTS-GLI-TrainingData/BraTS-GLI-02746-100/BraTS-GLI-02746-100-t2w.nii.gz,../../DataSet/BraTS2024-BraTS-GLI-TrainingData/BraTS-GLI-02746-100/BraTS-GLI-02746-100-t2f.nii.gz,../../DataSet/BraTS2024-BraTS-GLI-TrainingData/BraTS-GLI-02746-100/BraTS-GLI-02746-100-t1n.nii.gz,../../DataSet/BraTS2024-BraTS-GLI-TrainingData/BraTS-GLI-02746-100/BraTS-GLI-02746-100-seg.nii.gz,70,51,111,45,91,30,79,89,140,46,49,51
02797-100,../../DataSet/BraTS2024-BraTS-GLI-TrainingData/BraTS-GLI-02797-100/BraTS-GLI-02797-100-t1c.nii.gz,../../DataSet/BraTS2024-BraTS-GLI-TrainingData/BraTS-GLI-02797-100/BraTS-GLI-02797-100-t2w.nii.gz,../../DataSet/BraTS2024-BraTS-GLI-TrainingData/BraTS-GLI-02797-100/BraTS-GLI-02797-100-t2f.nii.gz,../../DataSet/BraTS2024-BraTS-GLI-TrainingData/BraTS-GLI-02797-100/BraTS-GLI-02797-100-t1n.nii.gz,../../DataSet/BraTS2024-BraTS-GLI-TrainingData/BraTS-GLI-02797-100/BraTS-GLI-02797-100-seg.nii.gz,57,89,111,41,78,76,111,101,123,37,35,22
02823-100,../../DataSet/BraTS2024-BraTS-GLI-TrainingData/BraTS-GLI-02823-100/BraTS-GLI-02823-100-t1c.nii.gz,../../DataSet/BraTS2024-BraTS-GLI-TrainingData/BraTS-GLI-02823-100/BraTS-GLI-02823-100-t2w.nii.gz,../../DataSet/BraTS2024-BraTS-GLI-TrainingData/BraTS-GLI-02823-100/BraTS-GLI-02823-100-t2f.nii.gz,../../DataSet/BraTS2024-BraTS-GLI-TrainingData/BraTS-GLI-02823-100/BraTS-GLI-02823-100-t1n.nii.gz,../../DataSet/BraTS2024-BraTS-GLI-TrainingData/BraTS-GLI-02823-100/BraTS-GLI-02823-100-seg.nii.gz,111,142,121,95,134,109,170,97,146,39,61,49
02885-101,../../DataSet/BraTS2024-BraTS-GLI-TrainingData/BraTS-GLI-02885-101/BraTS-GLI-02885-101-t1c.nii.gz,../../DataSet/BraTS2024-BraTS-GLI-TrainingData/BraTS-GLI-02885-101/BraTS-GLI-02885-101-t2w.nii.gz,../../DataSet/BraTS2024-BraTS-GLI-TrainingData/BraTS-GLI-02885-101/BraTS-GLI-02885-101-t2f.nii.gz,../../DataSet/BraTS2024-BraTS-GLI-TrainingData/BraTS-GLI-02885-101/BraTS-GLI-02885-101-t1n.nii.gz,../../DataSet/BraTS2024-BraTS-GLI-TrainingData/BraTS-GLI-02885-101/BraTS-GLI-02885-101-seg.nii.gz,128,55,104,111,149,34,79,81,128,38,45,47
02907-100,../../DataSet/BraTS2024-BraTS-GLI-TrainingData/BraTS-GLI-02907-100/BraTS-GLI-02907-100-t1c.nii.gz,../../DataSet/BraTS2024-BraTS-GLI-TrainingData/BraTS-GLI-02907-100/BraTS-GLI-02907-100-t2w.nii.gz,../../DataSet/BraTS2024-BraTS-GLI-TrainingData/BraTS-GLI-02907-100/BraTS-GLI-02907-100-t2f.nii.gz,../../DataSet/BraTS2024-BraTS-GLI-TrainingData/BraTS-GLI-02907-100/BraTS-GLI-02907-100-t1n.nii.gz,../../DataSet/BraTS2024-BraTS-GLI-TrainingData/BraTS-GLI-02907-100/BraTS-GLI-02907-100-seg.nii.gz,59,106,116,26,93,60,154,71,145,67,94,74
02854-101,../../DataSet/BraTS2024-BraTS-GLI-TrainingData/BraTS-GLI-02854-101/BraTS-GLI-02854-101-t1c.nii.gz,../../DataSet/BraTS2024-BraTS-GLI-TrainingData/BraTS-GLI-02854-101/BraTS-GLI-02854-101-t2w.nii.gz,../../DataSet/BraTS2024-BraTS-GLI-TrainingData/BraTS-GLI-02854-101/BraTS-GLI-02854-101-t2f.nii.gz,../../DataSet/BraTS2024-BraTS-GLI-TrainingData/BraTS-GLI-02854-101/BraTS-GLI-02854-101-t1n.nii.gz,../../DataSet/BraTS2024-BraTS-GLI-TrainingData/BraTS-GLI-02854-101/BraTS-GLI-02854-101-seg.nii.gz,123,52,96,99,151,22,109,59,126,52,87,67
00556-100,../../DataSet/BraTS2024-BraTS-GLI-TrainingData/BraTS-GLI-00556-100/BraTS-GLI-00556-100-t1c.nii.gz,../../DataSet/BraTS2024-BraTS-GLI-TrainingData/BraTS-GLI-00556-100/BraTS-GLI-00556-100-t2w.nii.gz,../../DataSet/BraTS2024-BraTS-GLI-TrainingData/BraTS-GLI-00556-100/BraTS-GLI-00556-100-t2f.nii.gz,../../DataSet/BraTS2024-BraTS-GLI-TrainingData/BraTS-GLI-00556-100/BraTS-GLI-00556-100-t1n.nii.gz,../../DataSet/BraTS2024-BraTS-GLI-TrainingData/BraTS-GLI-00556-100/BraTS-GLI-00556-100-seg.nii.gz,50,66,106,26,75,39,105,85,129,49,66,44
03022-100,../../DataSet/BraTS2024-BraTS-GLI-TrainingData/BraTS-GLI-03022-100/BraTS-GLI-03022-100-t1c.nii.gz,../../DataSet/BraTS2024-BraTS-GLI-TrainingData/BraTS-GLI-03022-100/BraTS-GLI-03022-100-t2w.nii.gz,../../DataSet/BraTS2024-BraTS-GLI-TrainingData/BraTS-GLI-03022-100/BraTS-GLI-03022-100-t2f.nii.gz,../../DataSet/BraTS2024-BraTS-GLI-TrainingData/BraTS-GLI-03022-100/BraTS-GLI-03022-100-t1n.nii.gz,../../DataSet/BraTS2024-BraTS-GLI-TrainingData/BraTS-GLI-03022-100/BraTS-GLI-03022-100-seg.nii.gz,59,95,129,43,76,82,111,112,145,33,29,33
02662-100,../../DataSet/BraTS2024-BraTS-GLI-TrainingData/BraTS-GLI-02662-100/BraTS-GLI-02662-100-t1c.nii.gz,../../DataSet/BraTS2024-BraTS-GLI-TrainingData/BraTS-GLI-02662-100/BraTS-GLI-02662-100-t2w.nii.gz,../../DataSet/BraTS2024-BraTS-GLI-TrainingData/BraTS-GLI-02662-100/BraTS-GLI-02662-100-t2f.nii.gz,../../DataSet/BraTS2024-BraTS-GLI-TrainingData/BraTS-GLI-02662-100/BraTS-GLI-02662-100-t1n.nii.gz,../../DataSet/BraTS2024-BraTS-GLI-TrainingData/BraTS-GLI-02662-100/BraTS-GLI-02662-100-seg.nii.gz,129,88,117,109,157,65,110,84,148,48,45,64
02208-101,../../DataSet/BraTS2024-BraTS-GLI-TrainingData/BraTS-GLI-02208-101/BraTS-GLI-02208-101-t1c.nii.gz,../../DataSet/BraTS2024-BraTS-GLI-TrainingData/BraTS-GLI-02208-101/BraTS-GLI-02208-101-t2w.nii.gz,../../DataSet/BraTS2024-BraTS-GLI-TrainingData/BraTS-GLI-02208-101/BraTS-GLI-02208-101-t2f.nii.gz,../../DataSet/BraTS2024-BraTS-GLI-TrainingData/BraTS-GLI-02208-101/BraTS-GLI-02208-101-t1n.nii.gz,../../DataSet/BraTS2024-BraTS-GLI-TrainingData/BraTS-GLI-02208-101/BraTS-GLI-02208-101-seg.nii.gz,118,63,93,94,157,33,109,71,113,63,76,42
02146-101,../../DataSet/BraTS2024-BraTS-GLI-TrainingData/BraTS-GLI-02146-101/BraTS-GLI-02146-101-t1c.nii.gz,../../DataSet/BraTS2024-BraTS-GLI-TrainingData/BraTS-GLI-02146-101/BraTS-GLI-02146-101-t2w.nii.gz,../../DataSet/BraTS2024-BraTS-GLI-TrainingData/BraTS-GLI-02146-101/BraTS-GLI-02146-101-t2f.nii.gz,../../DataSet/BraTS2024-BraTS-GLI-TrainingData/BraTS-GLI-02146-101/BraTS-GLI-02146-101-t1n.nii.gz,../../DataSet/BraTS2024-BraTS-GLI-TrainingData/BraTS-GLI-02146-101/BraTS-GLI-02146-101-seg.nii.gz,102,69,85,54,142,46,91,52,117,88,45,65
02763-100,../../DataSet/BraTS2024-BraTS-GLI-TrainingData/BraTS-GLI-02763-100/BraTS-GLI-02763-100-t1c.nii.gz,../../DataSet/BraTS2024-BraTS-GLI-TrainingData/BraTS-GLI-02763-100/BraTS-GLI-02763-100-t2w.nii.gz,../../DataSet/BraTS2024-BraTS-GLI-TrainingData/BraTS-GLI-02763-100/BraTS-GLI-02763-100-t2f.nii.gz,../../DataSet/BraTS2024-BraTS-GLI-TrainingData/BraTS-GLI-02763-100/BraTS-GLI-02763-100-t1n.nii.gz,../../DataSet/BraTS2024-BraTS-GLI-TrainingData/BraTS-GLI-02763-100/BraTS-GLI-02763-100-seg.nii.gz,108,123,127,84,131,84,157,106,152,47,73,46
02955-101,../../DataSet/BraTS2024-BraTS-GLI-TrainingData/BraTS-GLI-02955-101/BraTS-GLI-02955-101-t1c.nii.gz,../../DataSet/BraTS2024-BraTS-GLI-TrainingData/BraTS-GLI-02955-101/BraTS-GLI-02955-101-t2w.nii.gz,../../DataSet/BraTS2024-BraTS-GLI-TrainingData/BraTS-GLI-02955-101/BraTS-GLI-02955-101-t2f.nii.gz,../../DataSet/BraTS2024-BraTS-GLI-TrainingData/BraTS-GLI-02955-101/BraTS-GLI-02955-101-t1n.nii.gz,../../DataSet/BraTS2024-BraTS-GLI-TrainingData/BraTS-GLI-02955-101/BraTS-GLI-02955-101-seg.nii.gz,127,99,84,100,151,55,148,51,118,51,93,67
02806-100,../../DataSet/BraTS2024-BraTS-GLI-TrainingData/BraTS-GLI-02806-100/BraTS-GLI-02806-100-t1c.nii.gz,../../DataSet/BraTS2024-BraTS-GLI-TrainingData/BraTS-GLI-02806-100/BraTS-GLI-02806-100-t2w.nii.gz,../../DataSet/BraTS2024-BraTS-GLI-TrainingData/BraTS-GLI-02806-100/BraTS-GLI-02806-100-t2f.nii.gz,../../DataSet/BraTS2024-BraTS-GLI-TrainingData/BraTS-GLI-02806-100/BraTS-GLI-02806-100-t1n.nii.gz,../../DataSet/BraTS2024-BraTS-GLI-TrainingData/BraTS-GLI-02806-100/BraTS-GLI-02806-100-seg.nii.gz,56,99,108,29,75,56,152,81,133,46,96,52
02608-103,../../DataSet/BraTS2024-BraTS-GLI-TrainingData/BraTS-GLI-02608-103/BraTS-GLI-02608-103-t1c.nii.gz,../../DataSet/BraTS2024-BraTS-GLI-TrainingData/BraTS-GLI-02608-103/BraTS-GLI-02608-103-t2w.nii.gz,../../DataSet/BraTS2024-BraTS-GLI-TrainingData/BraTS-GLI-02608-103/BraTS-GLI-02608-103-t2f.nii.gz,../../DataSet/BraTS2024-BraTS-GLI-TrainingData/BraTS-GLI-02608-103/BraTS-GLI-02608-103-t1n.nii.gz,../../DataSet/BraTS2024-BraTS-GLI-TrainingData/BraTS-GLI-02608-103/BraTS-GLI-02608-103-seg.nii.gz,112,62,101,65,147,30,99,64,137,82,69,73
02175-102,../../DataSet/BraTS2024-BraTS-GLI-TrainingData/BraTS-GLI-02175-102/BraTS-GLI-02175-102-t1c.nii.gz,../../DataSet/BraTS2024-BraTS-GLI-TrainingData/BraTS-GLI-02175-102/BraTS-GLI-02175-102-t2w.nii.gz,../../DataSet/BraTS2024-BraTS-GLI-TrainingData/BraTS-GLI-02175-102/BraTS-GLI-02175-102-t2f.nii.gz,../../DataSet/BraTS2024-BraTS-GLI-TrainingData/BraTS-GLI-02175-102/BraTS-GLI-02175-102-t1n.nii.gz,../../DataSet/BraTS2024-BraTS-GLI-TrainingData/BraTS-GLI-02175-102/BraTS-GLI-02175-102-seg.nii.gz,130,78,86,105,155,45,117,56,117,50,72,61
02768-101,../../DataSet/BraTS2024-BraTS-GLI-TrainingData/BraTS-GLI-02768-101/BraTS-GLI-02768-101-t1c.nii.gz,../../DataSet/BraTS2024-BraTS-GLI-TrainingData/BraTS-GLI-02768-101/BraTS-GLI-02768-101-t2w.nii.gz,../../DataSet/BraTS2024-BraTS-GLI-TrainingData/BraTS-GLI-02768-101/BraTS-GLI-02768-101-t2f.nii.gz,../../DataSet/BraTS2024-BraTS-GLI-TrainingData/BraTS-GLI-02768-101/BraTS-GLI-02768-101-t1n.nii.gz,../../DataSet/BraTS2024-BraTS-GLI-TrainingData/BraTS-GLI-02768-101/BraTS-GLI-02768-101-seg.nii.gz,77,93,109,55,122,56,139,50,134,67,83,84
02215-103,../../DataSet/BraTS2024-BraTS-GLI-TrainingData/BraTS-GLI-02215-103/BraTS-GLI-02215-103-t1c.nii.gz,../../DataSet/BraTS2024-BraTS-GLI-TrainingData/BraTS-GLI-02215-103/BraTS-GLI-02215-103-t2w.nii.gz,../../DataSet/BraTS2024-BraTS-GLI-TrainingData/BraTS-GLI-02215-103/BraTS-GLI-02215-103-t2f.nii.gz,../../DataSet/BraTS2024-BraTS-GLI-TrainingData/BraTS-GLI-02215-103/BraTS-GLI-02215-103-t1n.nii.gz,../../DataSet/BraTS2024-BraTS-GLI-TrainingData/BraTS-GLI-02215-103/BraTS-GLI-02215-103-seg.nii.gz,123,91,108,100,150,63,142,80,131,50,79,51
02375-101,../../DataSet/BraTS2024-BraTS-GLI-TrainingData/BraTS-GLI-02375-101/BraTS-GLI-02375-101-t1c.nii.gz,../../DataSet/BraTS2024-BraTS-GLI-TrainingData/BraTS-GLI-02375-101/BraTS-GLI-02375-101-t2w.nii.gz,../../DataSet/BraTS2024-BraTS-GLI-TrainingData/BraTS-GLI-02375-101/BraTS-GLI-02375-101-t2f.nii.gz,../../DataSet/BraTS2024-BraTS-GLI-TrainingData/BraTS-GLI-02375-101/BraTS-GLI-02375-101-t1n.nii.gz,../../DataSet/BraTS2024-BraTS-GLI-TrainingData/BraTS-GLI-02375-101/BraTS-GLI-02375-101-seg.nii.gz,63,85,72,29,97,47,135,47,104,68,88,57
02204-104,../../DataSet/BraTS2024-BraTS-GLI-TrainingData/BraTS-GLI-02204-104/BraTS-GLI-02204-104-t1c.nii.gz,../../DataSet/BraTS2024-BraTS-GLI-TrainingData/BraTS-GLI-02204-104/BraTS-GLI-02204-104-t2w.nii.gz,../../DataSet/BraTS2024-BraTS-GLI-TrainingData/BraTS-GLI-02204-104/BraTS-GLI-02204-104-t2f.nii.gz,../../DataSet/BraTS2024-BraTS-GLI-TrainingData/BraTS-GLI-02204-104/BraTS-GLI-02204-104-t1n.nii.gz,../../DataSet/BraTS2024-BraTS-GLI-TrainingData/BraTS-GLI-02204-104/BraTS-GLI-02204-104-seg.nii.gz,72,124,70,43,104,84,165,44,93,61,81,49
02131-100,../../DataSet/BraTS2024-BraTS-GLI-TrainingData/BraTS-GLI-02131-100/BraTS-GLI-02131-100-t1c.nii.gz,../../DataSet/BraTS2024-BraTS-GLI-TrainingData/BraTS-GLI-02131-100/BraTS-GLI-02131-100-t2w.nii.gz,../../DataSet/BraTS2024-BraTS-GLI-TrainingData/BraTS-GLI-02131-100/BraTS-GLI-02131-100-t2f.nii.gz,../../DataSet/BraTS2024-BraTS-GLI-TrainingData/BraTS-GLI-02131-100/BraTS-GLI-02131-100-t1n.nii.gz,../../DataSet/BraTS2024-BraTS-GLI-TrainingData/BraTS-GLI-02131-100/BraTS-GLI-02131-100-seg.nii.gz,51,95,62,29,85,75,121,41,87,56,46,46
03007-100,../../DataSet/BraTS2024-BraTS-GLI-TrainingData/BraTS-GLI-03007-100/BraTS-GLI-03007-100-t1c.nii.gz,../../DataSet/BraTS2024-BraTS-GLI-TrainingData/BraTS-GLI-03007-100/BraTS-GLI-03007-100-t2w.nii.gz,../../DataSet/BraTS2024-BraTS-GLI-TrainingData/BraTS-GLI-03007-100/BraTS-GLI-03007-100-t2f.nii.gz,../../DataSet/BraTS2024-BraTS-GLI-TrainingData/BraTS-GLI-03007-100/BraTS-GLI-03007-100-t1n.nii.gz,../../DataSet/BraTS2024-BraTS-GLI-TrainingData/BraTS-GLI-03007-100/BraTS-GLI-03007-100-seg.nii.gz,49,120,70,23,79,87,149,45,112,56,62,67
02062-101,../../DataSet/BraTS2024-BraTS-GLI-TrainingData/BraTS-GLI-02062-101/BraTS-GLI-02062-101-t1c.nii.gz,../../DataSet/BraTS2024-BraTS-GLI-TrainingData/BraTS-GLI-02062-101/BraTS-GLI-02062-101-t2w.nii.gz,../../DataSet/BraTS2024-BraTS-GLI-TrainingData/BraTS-GLI-02062-101/BraTS-GLI-02062-101-t2f.nii.gz,../../DataSet/BraTS2024-BraTS-GLI-TrainingData/BraTS-GLI-02062-101/BraTS-GLI-02062-101-t1n.nii.gz,../../DataSet/BraTS2024-BraTS-GLI-TrainingData/BraTS-GLI-02062-101/BraTS-GLI-02062-101-seg.nii.gz,49,88,95,30,79,44,129,60,125,49,85,65
02871-101,../../DataSet/BraTS2024-BraTS-GLI-TrainingData/BraTS-GLI-02871-101/BraTS-GLI-02871-101-t1c.nii.gz,../../DataSet/BraTS2024-BraTS-GLI-TrainingData/BraTS-GLI-02871-101/BraTS-GLI-02871-101-t2w.nii.gz,../../DataSet/BraTS2024-BraTS-GLI-TrainingData/BraTS-GLI-02871-101/BraTS-GLI-02871-101-t2f.nii.gz,../../DataSet/BraTS2024-BraTS-GLI-TrainingData/BraTS-GLI-02871-101/BraTS-GLI-02871-101-t1n.nii.gz,../../DataSet/BraTS2024-BraTS-GLI-TrainingData/BraTS-GLI-02871-101/BraTS-GLI-02871-101-seg.nii.gz,101,141,120,71,128,115,170,86,150,57,55,64
02226-100,../../DataSet/BraTS2024-BraTS-GLI-TrainingData/BraTS-GLI-02226-100/BraTS-GLI-02226-100-t1c.nii.gz,../../DataSet/BraTS2024-BraTS-GLI-TrainingData/BraTS-GLI-02226-100/BraTS-GLI-02226-100-t2w.nii.gz,../../DataSet/BraTS2024-BraTS-GLI-TrainingData/BraTS-GLI-02226-100/BraTS-GLI-02226-100-t2f.nii.gz,../../DataSet/BraTS2024-BraTS-GLI-TrainingData/BraTS-GLI-02226-100/BraTS-GLI-02226-100-t1n.nii.gz,../../DataSet/BraTS2024-BraTS-GLI-TrainingData/BraTS-GLI-02226-100/BraTS-GLI-02226-100-seg.nii.gz,101,132,122,86,119,109,156,95,149,33,47,54
02105-103,../../DataSet/BraTS2024-BraTS-GLI-TrainingData/BraTS-GLI-02105-103/BraTS-GLI-02105-103-t1c.nii.gz,../../DataSet/BraTS2024-BraTS-GLI-TrainingData/BraTS-GLI-02105-103/BraTS-GLI-02105-103-t2w.nii.gz,../../DataSet/BraTS2024-BraTS-GLI-TrainingData/BraTS-GLI-02105-103/BraTS-GLI-02105-103-t2f.nii.gz,../../DataSet/BraTS2024-BraTS-GLI-TrainingData/BraTS-GLI-02105-103/BraTS-GLI-02105-103-t1n.nii.gz,../../DataSet/BraTS2024-BraTS-GLI-TrainingData/BraTS-GLI-02105-103/BraTS-GLI-02105-103-seg.nii.gz,73,82,126,51,90,68,98,85,152,39,30,67
02379-100,../../DataSet/BraTS2024-BraTS-GLI-TrainingData/BraTS-GLI-02379-100/BraTS-GLI-02379-100-t1c.nii.gz,../../DataSet/BraTS2024-BraTS-GLI-TrainingData/BraTS-GLI-02379-100/BraTS-GLI-02379-100-t2w.nii.gz,../../DataSet/BraTS2024-BraTS-GLI-TrainingData/BraTS-GLI-02379-100/BraTS-GLI-02379-100-t2f.nii.gz,../../DataSet/BraTS2024-BraTS-GLI-TrainingData/BraTS-GLI-02379-100/BraTS-GLI-02379-100-t1n.nii.gz,../../DataSet/BraTS2024-BraTS-GLI-TrainingData/BraTS-GLI-02379-100/BraTS-GLI-02379-100-seg.nii.gz,115,98,106,69,151,68,146,59,149,82,78,90
02390-102,../../DataSet/BraTS2024-BraTS-GLI-TrainingData/BraTS-GLI-02390-102/BraTS-GLI-02390-102-t1c.nii.gz,../../DataSet/BraTS2024-BraTS-GLI-TrainingData/BraTS-GLI-02390-102/BraTS-GLI-02390-102-t2w.nii.gz,../../DataSet/BraTS2024-BraTS-GLI-TrainingData/BraTS-GLI-02390-102/BraTS-GLI-02390-102-t2f.nii.gz,../../DataSet/BraTS2024-BraTS-GLI-TrainingData/BraTS-GLI-02390-102/BraTS-GLI-02390-102-t1n.nii.gz,../../DataSet/BraTS2024-BraTS-GLI-TrainingData/BraTS-GLI-02390-102/BraTS-GLI-02390-102-seg.nii.gz,55,72,98,33,81,51,112,70,118,48,61,48
02136-100,../../DataSet/BraTS2024-BraTS-GLI-TrainingData/BraTS-GLI-02136-100/BraTS-GLI-02136-100-t1c.nii.gz,../../DataSet/BraTS2024-BraTS-GLI-TrainingData/BraTS-GLI-02136-100/BraTS-GLI-02136-100-t2w.nii.gz,../../DataSet/BraTS2024-BraTS-GLI-TrainingData/BraTS-GLI-02136-100/BraTS-GLI-02136-100-t2f.nii.gz,../../DataSet/BraTS2024-BraTS-GLI-TrainingData/BraTS-GLI-02136-100/BraTS-GLI-02136-100-t1n.nii.gz,../../DataSet/BraTS2024-BraTS-GLI-TrainingData/BraTS-GLI-02136-100/BraTS-GLI-02136-100-seg.nii.gz,57,129,103,35,83,110,152,74,146,48,42,72
02876-101,../../DataSet/BraTS2024-BraTS-GLI-TrainingData/BraTS-GLI-02876-101/BraTS-GLI-02876-101-t1c.nii.gz,../../DataSet/BraTS2024-BraTS-GLI-TrainingData/BraTS-GLI-02876-101/BraTS-GLI-02876-101-t2w.nii.gz,../../DataSet/BraTS2024-BraTS-GLI-TrainingData/BraTS-GLI-02876-101/BraTS-GLI-02876-101-t2f.nii.gz,../../DataSet/BraTS2024-BraTS-GLI-TrainingData/BraTS-GLI-02876-101/BraTS-GLI-02876-101-t1n.nii.gz,../../DataSet/BraTS2024-BraTS-GLI-TrainingData/BraTS-GLI-02876-101/BraTS-GLI-02876-101-seg.nii.gz,72,56,97,34,126,31,98,51,140,92,67,89
02219-102,../../DataSet/BraTS2024-BraTS-GLI-TrainingData/BraTS-GLI-02219-102/BraTS-GLI-02219-102-t1c.nii.gz,../../DataSet/BraTS2024-BraTS-GLI-TrainingData/BraTS-GLI-02219-102/BraTS-GLI-02219-102-t2w.nii.gz,../../DataSet/BraTS2024-BraTS-GLI-TrainingData/BraTS-GLI-02219-102/BraTS-GLI-02219-102-t2f.nii.gz,../../DataSet/BraTS2024-BraTS-GLI-TrainingData/BraTS-GLI-02219-102/BraTS-GLI-02219-102-t1n.nii.gz,../../DataSet/BraTS2024-BraTS-GLI-TrainingData/BraTS-GLI-02219-102/BraTS-GLI-02219-102-seg.nii.gz,54,118,116,35,70,98,135,98,141,35,37,43
02287-101,../../DataSet/BraTS2024-BraTS-GLI-TrainingData/BraTS-GLI-02287-101/BraTS-GLI-02287-101-t1c.nii.gz,../../DataSet/BraTS2024-BraTS-GLI-TrainingData/BraTS-GLI-02287-101/BraTS-GLI-02287-101-t2w.nii.gz,../../DataSet/BraTS2024-BraTS-GLI-TrainingData/BraTS-GLI-02287-101/BraTS-GLI-02287-101-t2f.nii.gz,../../DataSet/BraTS2024-BraTS-GLI-TrainingData/BraTS-GLI-02287-101/BraTS-GLI-02287-101-t1n.nii.gz,../../DataSet/BraTS2024-BraTS-GLI-TrainingData/BraTS-GLI-02287-101/BraTS-GLI-02287-101-seg.nii.gz,46,95,91,23,87,54,148,58,128,64,94,70
02952-101,../../DataSet/BraTS2024-BraTS-GLI-TrainingData/BraTS-GLI-02952-101/BraTS-GLI-02952-101-t1c.nii.gz,../../DataSet/BraTS2024-BraTS-GLI-TrainingData/BraTS-GLI-02952-101/BraTS-GLI-02952-101-t2w.nii.gz,../../DataSet/BraTS2024-BraTS-GLI-TrainingData/BraTS-GLI-02952-101/BraTS-GLI-02952-101-t2f.nii.gz,../../DataSet/BraTS2024-BraTS-GLI-TrainingData/BraTS-GLI-02952-101/BraTS-GLI-02952-101-t1n.nii.gz,../../DataSet/BraTS2024-BraTS-GLI-TrainingData/BraTS-GLI-02952-101/BraTS-GLI-02952-101-seg.nii.gz,123,119,94,102,149,87,156,60,119,47,69,59
02256-101,../../DataSet/BraTS2024-BraTS-GLI-TrainingData/BraTS-GLI-02256-101/BraTS-GLI-02256-101-t1c.nii.gz,../../DataSet/BraTS2024-BraTS-GLI-TrainingData/BraTS-GLI-02256-101/BraTS-GLI-02256-101-t2w.nii.gz,../../DataSet/BraTS2024-BraTS-GLI-TrainingData/BraTS-GLI-02256-101/BraTS-GLI-02256-101-t2f.nii.gz,../../DataSet/BraTS2024-BraTS-GLI-TrainingData/BraTS-GLI-02256-101/BraTS-GLI-02256-101-t1n.nii.gz,../../DataSet/BraTS2024-BraTS-GLI-TrainingData/BraTS-GLI-02256-101/BraTS-GLI-02256-101-seg.nii.gz,47,80,91,27,72,44,137,67,118,45,93,51
02983-101,../../DataSet/BraTS2024-BraTS-GLI-TrainingData/BraTS-GLI-02983-101/BraTS-GLI-02983-101-t1c.nii.gz,../../DataSet/BraTS2024-BraTS-GLI-TrainingData/BraTS-GLI-02983-101/BraTS-GLI-02983-101-t2w.nii.gz,../../DataSet/BraTS2024-BraTS-GLI-TrainingData/BraTS-GLI-02983-101/BraTS-GLI-02983-101-t2f.nii.gz,../../DataSet/BraTS2024-BraTS-GLI-TrainingData/BraTS-GLI-02983-101/BraTS-GLI-02983-101-t1n.nii.gz,../../DataSet/BraTS2024-BraTS-GLI-TrainingData/BraTS-GLI-02983-101/BraTS-GLI-02983-101-seg.nii.gz,129,111,60,106,150,67,142,44,90,44,75,46
02637-101,../../DataSet/BraTS2024-BraTS-GLI-TrainingData/BraTS-GLI-02637-101/BraTS-GLI-02637-101-t1c.nii.gz,../../DataSet/BraTS2024-BraTS-GLI-TrainingData/BraTS-GLI-02637-101/BraTS-GLI-02637-101-t2w.nii.gz,../../DataSet/BraTS2024-BraTS-GLI-TrainingData/BraTS-GLI-02637-101/BraTS-GLI-02637-101-t2f.nii.gz,../../DataSet/BraTS2024-BraTS-GLI-TrainingData/BraTS-GLI-02637-101/BraTS-GLI-02637-101-t1n.nii.gz,../../DataSet/BraTS2024-BraTS-GLI-TrainingData/BraTS-GLI-02637-101/BraTS-GLI-02637-101-seg.nii.gz,67,127,119,39,91,99,158,95,148,52,59,53
02959-100,../../DataSet/BraTS2024-BraTS-GLI-TrainingData/BraTS-GLI-02959-100/BraTS-GLI-02959-100-t1c.nii.gz,../../DataSet/BraTS2024-BraTS-GLI-TrainingData/BraTS-GLI-02959-100/BraTS-GLI-02959-100-t2w.nii.gz,../../DataSet/BraTS2024-BraTS-GLI-TrainingData/BraTS-GLI-02959-100/BraTS-GLI-02959-100-t2f.nii.gz,../../DataSet/BraTS2024-BraTS-GLI-TrainingData/BraTS-GLI-02959-100/BraTS-GLI-02959-100-t1n.nii.gz,../../DataSet/BraTS2024-BraTS-GLI-TrainingData/BraTS-GLI-02959-100/BraTS-GLI-02959-100-seg.nii.gz,112,92,84,72,146,50,141,56,146,74,91,90
02988-100,../../DataSet/BraTS2024-BraTS-GLI-TrainingData/BraTS-GLI-02988-100/BraTS-GLI-02988-100-t1c.nii.gz,../../DataSet/BraTS2024-BraTS-GLI-TrainingData/BraTS-GLI-02988-100/BraTS-GLI-02988-100-t2w.nii.gz,../../DataSet/BraTS2024-BraTS-GLI-TrainingData/BraTS-GLI-02988-100/BraTS-GLI-02988-100-t2f.nii.gz,../../DataSet/BraTS2024-BraTS-GLI-TrainingData/BraTS-GLI-02988-100/BraTS-GLI-02988-100-t1n.nii.gz,../../DataSet/BraTS2024-BraTS-GLI-TrainingData/BraTS-GLI-02988-100/BraTS-GLI-02988-100-seg.nii.gz,49,119,110,29,75,95,142,86,139,46,47,53
02111-105,../../DataSet/BraTS2024-BraTS-GLI-TrainingData/BraTS-GLI-02111-105/BraTS-GLI-02111-105-t1c.nii.gz,../../DataSet/BraTS2024-BraTS-GLI-TrainingData/BraTS-GLI-02111-105/BraTS-GLI-02111-105-t2w.nii.gz,../../DataSet/BraTS2024-BraTS-GLI-TrainingData/BraTS-GLI-02111-105/BraTS-GLI-02111-105-t2f.nii.gz,../../DataSet/BraTS2024-BraTS-GLI-TrainingData/BraTS-GLI-02111-105/BraTS-GLI-02111-105-t1n.nii.gz,../../DataSet/BraTS2024-BraTS-GLI-TrainingData/BraTS-GLI-02111-105/BraTS-GLI-02111-105-seg.nii.gz,73,77,111,52,119,49,117,73,150,67,68,77
02093-104,../../DataSet/BraTS2024-BraTS-GLI-TrainingData/BraTS-GLI-02093-104/BraTS-GLI-02093-104-t1c.nii.gz,../../DataSet/BraTS2024-BraTS-GLI-TrainingData/BraTS-GLI-02093-104/BraTS-GLI-02093-104-t2w.nii.gz,../../DataSet/BraTS2024-BraTS-GLI-TrainingData/BraTS-GLI-02093-104/BraTS-GLI-02093-104-t2f.nii.gz,../../DataSet/BraTS2024-BraTS-GLI-TrainingData/BraTS-GLI-02093-104/BraTS-GLI-02093-104-t1n.nii.gz,../../DataSet/BraTS2024-BraTS-GLI-TrainingData/BraTS-GLI-02093-104/BraTS-GLI-02093-104-seg.nii.gz,109,171,94,68,139,116,202,54,141,71,86,87
02873-100,../../DataSet/BraTS2024-BraTS-GLI-TrainingData/BraTS-GLI-02873-100/BraTS-GLI-02873-100-t1c.nii.gz,../../DataSet/BraTS2024-BraTS-GLI-TrainingData/BraTS-GLI-02873-100/BraTS-GLI-02873-100-t2w.nii.gz,../../DataSet/BraTS2024-BraTS-GLI-TrainingData/BraTS-GLI-02873-100/BraTS-GLI-02873-100-t2f.nii.gz,../../DataSet/BraTS2024-BraTS-GLI-TrainingData/BraTS-GLI-02873-100/BraTS-GLI-02873-100-t1n.nii.gz,../../DataSet/BraTS2024-BraTS-GLI-TrainingData/BraTS-GLI-02873-100/BraTS-GLI-02873-100-seg.nii.gz,132,113,65,104,153,58,147,43,87,49,89,44
02138-100,../../DataSet/BraTS2024-BraTS-GLI-TrainingData/BraTS-GLI-02138-100/BraTS-GLI-02138-100-t1c.nii.gz,../../DataSet/BraTS2024-BraTS-GLI-TrainingData/BraTS-GLI-02138-100/BraTS-GLI-02138-100-t2w.nii.gz,../../DataSet/BraTS2024-BraTS-GLI-TrainingData/BraTS-GLI-02138-100/BraTS-GLI-02138-100-t2f.nii.gz,../../DataSet/BraTS2024-BraTS-GLI-TrainingData/BraTS-GLI-02138-100/BraTS-GLI-02138-100-t1n.nii.gz,../../DataSet/BraTS2024-BraTS-GLI-TrainingData/BraTS-GLI-02138-100/BraTS-GLI-02138-100-seg.nii.gz,106,119,121,90,127,64,156,97,150,37,92,53
02878-101,../../DataSet/BraTS2024-BraTS-GLI-TrainingData/BraTS-GLI-02878-101/BraTS-GLI-02878-101-t1c.nii.gz,../../DataSet/BraTS2024-BraTS-GLI-TrainingData/BraTS-GLI-02878-101/BraTS-GLI-02878-101-t2w.nii.gz,../../DataSet/BraTS2024-BraTS-GLI-TrainingData/BraTS-GLI-02878-101/BraTS-GLI-02878-101-t2f.nii.gz,../../DataSet/BraTS2024-BraTS-GLI-TrainingData/BraTS-GLI-02878-101/BraTS-GLI-02878-101-t1n.nii.gz,../../DataSet/BraTS2024-BraTS-GLI-TrainingData/BraTS-GLI-02878-101/BraTS-GLI-02878-101-seg.nii.gz,68,150,97,47,103,102,185,67,131,56,83,64
02217-102,../../DataSet/BraTS2024-BraTS-GLI-TrainingData/BraTS-GLI-02217-102/BraTS-GLI-02217-102-t1c.nii.gz,../../DataSet/BraTS2024-BraTS-GLI-TrainingData/BraTS-GLI-02217-102/BraTS-GLI-02217-102-t2w.nii.gz,../../DataSet/BraTS2024-BraTS-GLI-TrainingData/BraTS-GLI-02217-102/BraTS-GLI-02217-102-t2f.nii.gz,../../DataSet/BraTS2024-BraTS-GLI-TrainingData/BraTS-GLI-02217-102/BraTS-GLI-02217-102-t1n.nii.gz,../../DataSet/BraTS2024-BraTS-GLI-TrainingData/BraTS-GLI-02217-102/BraTS-GLI-02217-102-seg.nii.gz,130,126,91,114,149,105,148,69,111,35,43,42
02289-101,../../DataSet/BraTS2024-BraTS-GLI-TrainingData/BraTS-GLI-02289-101/BraTS-GLI-02289-101-t1c.nii.gz,../../DataSet/BraTS2024-BraTS-GLI-TrainingData/BraTS-GLI-02289-101/BraTS-GLI-02289-101-t2w.nii.gz,../../DataSet/BraTS2024-BraTS-GLI-TrainingData/BraTS-GLI-02289-101/BraTS-GLI-02289-101-t2f.nii.gz,../../DataSet/BraTS2024-BraTS-GLI-TrainingData/BraTS-GLI-02289-101/BraTS-GLI-02289-101-t1n.nii.gz,../../DataSet/BraTS2024-BraTS-GLI-TrainingData/BraTS-GLI-02289-101/BraTS-GLI-02289-101-seg.nii.gz,117,129,101,98,142,78,166,64,131,44,88,67
02258-101,../../DataSet/BraTS2024-BraTS-GLI-TrainingData/BraTS-GLI-02258-101/BraTS-GLI-02258-101-t1c.nii.gz,../../DataSet/BraTS2024-BraTS-GLI-TrainingData/BraTS-GLI-02258-101/BraTS-GLI-02258-101-t2w.nii.gz,../../DataSet/BraTS2024-BraTS-GLI-TrainingData/BraTS-GLI-02258-101/BraTS-GLI-02258-101-t2f.nii.gz,../../DataSet/BraTS2024-BraTS-GLI-TrainingData/BraTS-GLI-02258-101/BraTS-GLI-02258-101-t1n.nii.gz,../../DataSet/BraTS2024-BraTS-GLI-TrainingData/BraTS-GLI-02258-101/BraTS-GLI-02258-101-seg.nii.gz,112,173,88,76,148,139,211,48,125,72,72,77
02300-101,../../DataSet/BraTS2024-BraTS-GLI-TrainingData/BraTS-GLI-02300-101/BraTS-GLI-02300-101-t1c.nii.gz,../../DataSet/BraTS2024-BraTS-GLI-TrainingData/BraTS-GLI-02300-101/BraTS-GLI-02300-101-t2w.nii.gz,../../DataSet/BraTS2024-BraTS-GLI-TrainingData/BraTS-GLI-02300-101/BraTS-GLI-02300-101-t2f.nii.gz,../../DataSet/BraTS2024-BraTS-GLI-TrainingData/BraTS-GLI-02300-101/BraTS-GLI-02300-101-t1n.nii.gz,../../DataSet/BraTS2024-BraTS-GLI-TrainingData/BraTS-GLI-02300-101/BraTS-GLI-02300-101-seg.nii.gz,92,149,122,59,121,122,180,96,149,62,58,53
02957-100,../../DataSet/BraTS2024-BraTS-GLI-TrainingData/BraTS-GLI-02957-100/BraTS-GLI-02957-100-t1c.nii.gz,../../DataSet/BraTS2024-BraTS-GLI-TrainingData/BraTS-GLI-02957-100/BraTS-GLI-02957-100-t2w.nii.gz,../../DataSet/BraTS2024-BraTS-GLI-TrainingData/BraTS-GLI-02957-100/BraTS-GLI-02957-100-t2f.nii.gz,../../DataSet/BraTS2024-BraTS-GLI-TrainingData/BraTS-GLI-02957-100/BraTS-GLI-02957-100-t1n.nii.gz,../../DataSet/BraTS2024-BraTS-GLI-TrainingData/BraTS-GLI-02957-100/BraTS-GLI-02957-100-seg.nii.gz,80,174,101,67,92,156,190,82,123,25,34,41
02761-101,../../DataSet/BraTS2024-BraTS-GLI-TrainingData/BraTS-GLI-02761-101/BraTS-GLI-02761-101-t1c.nii.gz,../../DataSet/BraTS2024-BraTS-GLI-TrainingData/BraTS-GLI-02761-101/BraTS-GLI-02761-101-t2w.nii.gz,../../DataSet/BraTS2024-BraTS-GLI-TrainingData/BraTS-GLI-02761-101/BraTS-GLI-02761-101-t2f.nii.gz,../../DataSet/BraTS2024-BraTS-GLI-TrainingData/BraTS-GLI-02761-101/BraTS-GLI-02761-101-t1n.nii.gz,../../DataSet/BraTS2024-BraTS-GLI-TrainingData/BraTS-GLI-02761-101/BraTS-GLI-02761-101-seg.nii.gz,138,82,66,125,152,60,107,55,80,27,47,25
02144-100,../../DataSet/BraTS2024-BraTS-GLI-TrainingData/BraTS-GLI-02144-100/BraTS-GLI-02144-100-t1c.nii.gz,../../DataSet/BraTS2024-BraTS-GLI-TrainingData/BraTS-GLI-02144-100/BraTS-GLI-02144-100-t2w.nii.gz,../../DataSet/BraTS2024-BraTS-GLI-TrainingData/BraTS-GLI-02144-100/BraTS-GLI-02144-100-t2f.nii.gz,../../DataSet/BraTS2024-BraTS-GLI-TrainingData/BraTS-GLI-02144-100/BraTS-GLI-02144-100-t1n.nii.gz,../../DataSet/BraTS2024-BraTS-GLI-TrainingData/BraTS-GLI-02144-100/BraTS-GLI-02144-100-seg.nii.gz,114,107,119,89,150,73,142,91,152,61,69,61
02195-100,../../DataSet/BraTS2024-BraTS-GLI-TrainingData/BraTS-GLI-02195-100/BraTS-GLI-02195-100-t1c.nii.gz,../../DataSet/BraTS2024-BraTS-GLI-TrainingData/BraTS-GLI-02195-100/BraTS-GLI-02195-100-t2w.nii.gz,../../DataSet/BraTS2024-BraTS-GLI-TrainingData/BraTS-GLI-02195-100/BraTS-GLI-02195-100-t2f.nii.gz,../../DataSet/BraTS2024-BraTS-GLI-TrainingData/BraTS-GLI-02195-100/BraTS-GLI-02195-100-t1n.nii.gz,../../DataSet/BraTS2024-BraTS-GLI-TrainingData/BraTS-GLI-02195-100/BraTS-GLI-02195-100-seg.nii.gz,126,124,54,95,150,92,157,34,81,55,65,47
02632-100,../../DataSet/BraTS2024-BraTS-GLI-TrainingData/BraTS-GLI-02632-100/BraTS-GLI-02632-100-t1c.nii.gz,../../DataSet/BraTS2024-BraTS-GLI-TrainingData/BraTS-GLI-02632-100/BraTS-GLI-02632-100-t2w.nii.gz,../../DataSet/BraTS2024-BraTS-GLI-TrainingData/BraTS-GLI-02632-100/BraTS-GLI-02632-100-t2f.nii.gz,../../DataSet/BraTS2024-BraTS-GLI-TrainingData/BraTS-GLI-02632-100/BraTS-GLI-02632-100-t1n.nii.gz,../../DataSet/BraTS2024-BraTS-GLI-TrainingData/BraTS-GLI-02632-100/BraTS-GLI-02632-100-seg.nii.gz,119,53,85,101,141,30,85,65,111,40,55,46
02804-101,../../DataSet/BraTS2024-BraTS-GLI-TrainingData/BraTS-GLI-02804-101/BraTS-GLI-02804-101-t1c.nii.gz,../../DataSet/BraTS2024-BraTS-GLI-TrainingData/BraTS-GLI-02804-101/BraTS-GLI-02804-101-t2w.nii.gz,../../DataSet/BraTS2024-BraTS-GLI-TrainingData/BraTS-GLI-02804-101/BraTS-GLI-02804-101-t2f.nii.gz,../../DataSet/BraTS2024-BraTS-GLI-TrainingData/BraTS-GLI-02804-101/BraTS-GLI-02804-101-t1n.nii.gz,../../DataSet/BraTS2024-BraTS-GLI-TrainingData/BraTS-GLI-02804-101/BraTS-GLI-02804-101-seg.nii.gz,122,74,92,87,151,34,123,50,132,64,89,82
00506-100,../../DataSet/BraTS2024-BraTS-GLI-TrainingData/BraTS-GLI-00506-100/BraTS-GLI-00506-100-t1c.nii.gz,../../DataSet/BraTS2024-BraTS-GLI-TrainingData/BraTS-GLI-00506-100/BraTS-GLI-00506-100-t2w.nii.gz,../../DataSet/BraTS2024-BraTS-GLI-TrainingData/BraTS-GLI-00506-100/BraTS-GLI-00506-100-t2f.nii.gz,../../DataSet/BraTS2024-BraTS-GLI-TrainingData/BraTS-GLI-00506-100/BraTS-GLI-00506-100-t1n.nii.gz,../../DataSet/BraTS2024-BraTS-GLI-TrainingData/BraTS-GLI-00506-100/BraTS-GLI-00506-100-seg.nii.gz,75,74,122,48,104,38,108,95,149,56,70,54
02199-101,../../DataSet/BraTS2024-BraTS-GLI-TrainingData/BraTS-GLI-02199-101/BraTS-GLI-02199-101-t1c.nii.gz,../../DataSet/BraTS2024-BraTS-GLI-TrainingData/BraTS-GLI-02199-101/BraTS-GLI-02199-101-t2w.nii.gz,../../DataSet/BraTS2024-BraTS-GLI-TrainingData/BraTS-GLI-02199-101/BraTS-GLI-02199-101-t2f.nii.gz,../../DataSet/BraTS2024-BraTS-GLI-TrainingData/BraTS-GLI-02199-101/BraTS-GLI-02199-101-t1n.nii.gz,../../DataSet/BraTS2024-BraTS-GLI-TrainingData/BraTS-GLI-02199-101/BraTS-GLI-02199-101-seg.nii.gz,104,164,94,72,125,140,185,65,130,53,45,65
02285-100,../../DataSet/BraTS2024-BraTS-GLI-TrainingData/BraTS-GLI-02285-100/BraTS-GLI-02285-100-t1c.nii.gz,../../DataSet/BraTS2024-BraTS-GLI-TrainingData/BraTS-GLI-02285-100/BraTS-GLI-02285-100-t2w.nii.gz,../../DataSet/BraTS2024-BraTS-GLI-TrainingData/BraTS-GLI-02285-100/BraTS-GLI-02285-100-t2f.nii.gz,../../DataSet/BraTS2024-BraTS-GLI-TrainingData/BraTS-GLI-02285-100/BraTS-GLI-02285-100-t1n.nii.gz,../../DataSet/BraTS2024-BraTS-GLI-TrainingData/BraTS-GLI-02285-100/BraTS-GLI-02285-100-seg.nii.gz,108,56,95,92,139,37,78,78,115,47,41,37
02307-101,../../DataSet/BraTS2024-BraTS-GLI-TrainingData/BraTS-GLI-02307-101/BraTS-GLI-02307-101-t1c.nii.gz,../../DataSet/BraTS2024-BraTS-GLI-TrainingData/BraTS-GLI-02307-101/BraTS-GLI-02307-101-t2w.nii.gz,../../DataSet/BraTS2024-BraTS-GLI-TrainingData/BraTS-GLI-02307-101/BraTS-GLI-02307-101-t2f.nii.gz,../../DataSet/BraTS2024-BraTS-GLI-TrainingData/BraTS-GLI-02307-101/BraTS-GLI-02307-101-t1n.nii.gz,../../DataSet/BraTS2024-BraTS-GLI-TrainingData/BraTS-GLI-02307-101/BraTS-GLI-02307-101-seg.nii.gz,54,73,82,30,89,42,110,51,113,59,68,62
02635-100,../../DataSet/BraTS2024-BraTS-GLI-TrainingData/BraTS-GLI-02635-100/BraTS-GLI-02635-100-t1c.nii.gz,../../DataSet/BraTS2024-BraTS-GLI-TrainingData/BraTS-GLI-02635-100/BraTS-GLI-02635-100-t2w.nii.gz,../../DataSet/BraTS2024-BraTS-GLI-TrainingData/BraTS-GLI-02635-100/BraTS-GLI-02635-100-t2f.nii.gz,../../DataSet/BraTS2024-BraTS-GLI-TrainingData/BraTS-GLI-02635-100/BraTS-GLI-02635-100-t1n.nii.gz,../../DataSet/BraTS2024-BraTS-GLI-TrainingData/BraTS-GLI-02635-100/BraTS-GLI-02635-100-seg.nii.gz,126,109,78,119,137,90,132,61,94,18,42,33
02192-100,../../DataSet/BraTS2024-BraTS-GLI-TrainingData/BraTS-GLI-02192-100/BraTS-GLI-02192-100-t1c.nii.gz,../../DataSet/BraTS2024-BraTS-GLI-TrainingData/BraTS-GLI-02192-100/BraTS-GLI-02192-100-t2w.nii.gz,../../DataSet/BraTS2024-BraTS-GLI-TrainingData/BraTS-GLI-02192-100/BraTS-GLI-02192-100-t2f.nii.gz,../../DataSet/BraTS2024-BraTS-GLI-TrainingData/BraTS-GLI-02192-100/BraTS-GLI-02192-100-t1n.nii.gz,../../DataSet/BraTS2024-BraTS-GLI-TrainingData/BraTS-GLI-02192-100/BraTS-GLI-02192-100-seg.nii.gz,115,62,91,56,146,23,99,56,125,90,76,69
02254-100,../../DataSet/BraTS2024-BraTS-GLI-TrainingData/BraTS-GLI-02254-100/BraTS-GLI-02254-100-t1c.nii.gz,../../DataSet/BraTS2024-BraTS-GLI-TrainingData/BraTS-GLI-02254-100/BraTS-GLI-02254-100-t2w.nii.gz,../../DataSet/BraTS2024-BraTS-GLI-TrainingData/BraTS-GLI-02254-100/BraTS-GLI-02254-100-t2f.nii.gz,../../DataSet/BraTS2024-BraTS-GLI-TrainingData/BraTS-GLI-02254-100/BraTS-GLI-02254-100-t1n.nii.gz,../../DataSet/BraTS2024-BraTS-GLI-TrainingData/BraTS-GLI-02254-100/BraTS-GLI-02254-100-seg.nii.gz,41,91,88,25,65,76,111,79,98,40,35,19
02803-101,../../DataSet/BraTS2024-BraTS-GLI-TrainingData/BraTS-GLI-02803-101/BraTS-GLI-02803-101-t1c.nii.gz,../../DataSet/BraTS2024-BraTS-GLI-TrainingData/BraTS-GLI-02803-101/BraTS-GLI-02803-101-t2w.nii.gz,../../DataSet/BraTS2024-BraTS-GLI-TrainingData/BraTS-GLI-02803-101/BraTS-GLI-02803-101-t2f.nii.gz,../../DataSet/BraTS2024-BraTS-GLI-TrainingData/BraTS-GLI-02803-101/BraTS-GLI-02803-101-t1n.nii.gz,../../DataSet/BraTS2024-BraTS-GLI-TrainingData/BraTS-GLI-02803-101/BraTS-GLI-02803-101-seg.nii.gz,46,80,77,26,80,42,123,52,107,54,81,55
02981-100,../../DataSet/BraTS2024-BraTS-GLI-TrainingData/BraTS-GLI-02981-100/BraTS-GLI-02981-100-t1c.nii.gz,../../DataSet/BraTS2024-BraTS-GLI-TrainingData/BraTS-GLI-02981-100/BraTS-GLI-02981-100-t2w.nii.gz,../../DataSet/BraTS2024-BraTS-GLI-TrainingData/BraTS-GLI-02981-100/BraTS-GLI-02981-100-t2f.nii.gz,../../DataSet/BraTS2024-BraTS-GLI-TrainingData/BraTS-GLI-02981-100/BraTS-GLI-02981-100-t1n.nii.gz,../../DataSet/BraTS2024-BraTS-GLI-TrainingData/BraTS-GLI-02981-100/BraTS-GLI-02981-100-seg.nii.gz,126,115,41,101,152,80,146,20,61,51,66,41
02698-100,../../DataSet/BraTS2024-BraTS-GLI-TrainingData/BraTS-GLI-02698-100/BraTS-GLI-02698-100-t1c.nii.gz,../../DataSet/BraTS2024-BraTS-GLI-TrainingData/BraTS-GLI-02698-100/BraTS-GLI-02698-100-t2w.nii.gz,../../DataSet/BraTS2024-BraTS-GLI-TrainingData/BraTS-GLI-02698-100/BraTS-GLI-02698-100-t2f.nii.gz,../../DataSet/BraTS2024-BraTS-GLI-TrainingData/BraTS-GLI-02698-100/BraTS-GLI-02698-100-t1n.nii.gz,../../DataSet/BraTS2024-BraTS-GLI-TrainingData/BraTS-GLI-02698-100/BraTS-GLI-02698-100-seg.nii.gz,135,121,52,109,159,61,151,23,91,50,90,68
02649-100,../../DataSet/BraTS2024-BraTS-GLI-TrainingData/BraTS-GLI-02649-100/BraTS-GLI-02649-100-t1c.nii.gz,../../DataSet/BraTS2024-BraTS-GLI-TrainingData/BraTS-GLI-02649-100/BraTS-GLI-02649-100-t2w.nii.gz,../../DataSet/BraTS2024-BraTS-GLI-TrainingData/BraTS-GLI-02649-100/BraTS-GLI-02649-100-t2f.nii.gz,../../DataSet/BraTS2024-BraTS-GLI-TrainingData/BraTS-GLI-02649-100/BraTS-GLI-02649-100-t1n.nii.gz,../../DataSet/BraTS2024-BraTS-GLI-TrainingData/BraTS-GLI-02649-100/BraTS-GLI-02649-100-seg.nii.gz,121,170,80,108,140,151,193,56,109,32,42,53
03009-100,../../DataSet/BraTS2024-BraTS-GLI-TrainingData/BraTS-GLI-03009-100/BraTS-GLI-03009-100-t1c.nii.gz,../../DataSet/BraTS2024-BraTS-GLI-TrainingData/BraTS-GLI-03009-100/BraTS-GLI-03009-100-t2w.nii.gz,../../DataSet/BraTS2024-BraTS-GLI-TrainingData/BraTS-GLI-03009-100/BraTS-GLI-03009-100-t2f.nii.gz,../../DataSet/BraTS2024-BraTS-GLI-TrainingData/BraTS-GLI-03009-100/BraTS-GLI-03009-100-t1n.nii.gz,../../DataSet/BraTS2024-BraTS-GLI-TrainingData/BraTS-GLI-03009-100/BraTS-GLI-03009-100-seg.nii.gz,64,51,73,39,85,22,101,48,107,46,79,59
02228-100,../../DataSet/BraTS2024-BraTS-GLI-TrainingData/BraTS-GLI-02228-100/BraTS-GLI-02228-100-t1c.nii.gz,../../DataSet/BraTS2024-BraTS-GLI-TrainingData/BraTS-GLI-02228-100/BraTS-GLI-02228-100-t2w.nii.gz,../../DataSet/BraTS2024-BraTS-GLI-TrainingData/BraTS-GLI-02228-100/BraTS-GLI-02228-100-t2f.nii.gz,../../DataSet/BraTS2024-BraTS-GLI-TrainingData/BraTS-GLI-02228-100/BraTS-GLI-02228-100-t1n.nii.gz,../../DataSet/BraTS2024-BraTS-GLI-TrainingData/BraTS-GLI-02228-100/BraTS-GLI-02228-100-seg.nii.gz,107,136,105,78,134,115,166,58,150,56,51,92
02789-100,../../DataSet/BraTS2024-BraTS-GLI-TrainingData/BraTS-GLI-02789-100/BraTS-GLI-02789-100-t1c.nii.gz,../../DataSet/BraTS2024-BraTS-GLI-TrainingData/BraTS-GLI-02789-100/BraTS-GLI-02789-100-t2w.nii.gz,../../DataSet/BraTS2024-BraTS-GLI-TrainingData/BraTS-GLI-02789-100/BraTS-GLI-02789-100-t2f.nii.gz,../../DataSet/BraTS2024-BraTS-GLI-TrainingData/BraTS-GLI-02789-100/BraTS-GLI-02789-100-t1n.nii.gz,../../DataSet/BraTS2024-BraTS-GLI-TrainingData/BraTS-GLI-02789-100/BraTS-GLI-02789-100-seg.nii.gz,58,125,101,27,107,92,157,62,136,80,65,74
02339-100,../../DataSet/BraTS2024-BraTS-GLI-TrainingData/BraTS-GLI-02339-100/BraTS-GLI-02339-100-t1c.nii.gz,../../DataSet/BraTS2024-BraTS-GLI-TrainingData/BraTS-GLI-02339-100/BraTS-GLI-02339-100-t2w.nii.gz,../../DataSet/BraTS2024-BraTS-GLI-TrainingData/BraTS-GLI-02339-100/BraTS-GLI-02339-100-t2f.nii.gz,../../DataSet/BraTS2024-BraTS-GLI-TrainingData/BraTS-GLI-02339-100/BraTS-GLI-02339-100-t1n.nii.gz,../../DataSet/BraTS2024-BraTS-GLI-TrainingData/BraTS-GLI-02339-100/BraTS-GLI-02339-100-seg.nii.gz,110,136,79,68,151,106,162,48,107,83,56,59
02758-100,../../DataSet/BraTS2024-BraTS-GLI-TrainingData/BraTS-GLI-02758-100/BraTS-GLI-02758-100-t1c.nii.gz,../../DataSet/BraTS2024-BraTS-GLI-TrainingData/BraTS-GLI-02758-100/BraTS-GLI-02758-100-t2w.nii.gz,../../DataSet/BraTS2024-BraTS-GLI-TrainingData/BraTS-GLI-02758-100/BraTS-GLI-02758-100-t2f.nii.gz,../../DataSet/BraTS2024-BraTS-GLI-TrainingData/BraTS-GLI-02758-100/BraTS-GLI-02758-100-t1n.nii.gz,../../DataSet/BraTS2024-BraTS-GLI-TrainingData/BraTS-GLI-02758-100/BraTS-GLI-02758-100-seg.nii.gz,105,171,85,86,133,143,191,67,117,47,48,50
02836-101,../../DataSet/BraTS2024-BraTS-GLI-TrainingData/BraTS-GLI-02836-101/BraTS-GLI-02836-101-t1c.nii.gz,../../DataSet/BraTS2024-BraTS-GLI-TrainingData/BraTS-GLI-02836-101/BraTS-GLI-02836-101-t2w.nii.gz,../../DataSet/BraTS2024-BraTS-GLI-TrainingData/BraTS-GLI-02836-101/BraTS-GLI-02836-101-t2f.nii.gz,../../DataSet/BraTS2024-BraTS-GLI-TrainingData/BraTS-GLI-02836-101/BraTS-GLI-02836-101-t1n.nii.gz,../../DataSet/BraTS2024-BraTS-GLI-TrainingData/BraTS-GLI-02836-101/BraTS-GLI-02836-101-seg.nii.gz,56,125,84,29,91,83,156,53,119,62,73,66
00006-101,../../DataSet/BraTS2024-BraTS-GLI-TrainingData/BraTS-GLI-00006-101/BraTS-GLI-00006-101-t1c.nii.gz,../../DataSet/BraTS2024-BraTS-GLI-TrainingData/BraTS-GLI-00006-101/BraTS-GLI-00006-101-t2w.nii.gz,../../DataSet/BraTS2024-BraTS-GLI-TrainingData/BraTS-GLI-00006-101/BraTS-GLI-00006-101-t2f.nii.gz,../../DataSet/BraTS2024-BraTS-GLI-TrainingData/BraTS-GLI-00006-101/BraTS-GLI-00006-101-t1n.nii.gz,../../DataSet/BraTS2024-BraTS-GLI-TrainingData/BraTS-GLI-00006-101/BraTS-GLI-00006-101-seg.nii.gz,106,169,90,68,132,135,195,69,117,64,60,48
02965-100,../../DataSet/BraTS2024-BraTS-GLI-TrainingData/BraTS-GLI-02965-100/BraTS-GLI-02965-100-t1c.nii.gz,../../DataSet/BraTS2024-BraTS-GLI-TrainingData/BraTS-GLI-02965-100/BraTS-GLI-02965-100-t2w.nii.gz,../../DataSet/BraTS2024-BraTS-GLI-TrainingData/BraTS-GLI-02965-100/BraTS-GLI-02965-100-t2f.nii.gz,../../DataSet/BraTS2024-BraTS-GLI-TrainingData/BraTS-GLI-02965-100/BraTS-GLI-02965-100-t1n.nii.gz,../../DataSet/BraTS2024-BraTS-GLI-TrainingData/BraTS-GLI-02965-100/BraTS-GLI-02965-100-seg.nii.gz,40,107,75,23,66,65,149,53,101,43,84,48
02517-100,../../DataSet/BraTS2024-BraTS-GLI-TrainingData/BraTS-GLI-02517-100/BraTS-GLI-02517-100-t1c.nii.gz,../../DataSet/BraTS2024-BraTS-GLI-TrainingData/BraTS-GLI-02517-100/BraTS-GLI-02517-100-t2w.nii.gz,../../DataSet/BraTS2024-BraTS-GLI-TrainingData/BraTS-GLI-02517-100/BraTS-GLI-02517-100-t2f.nii.gz,../../DataSet/BraTS2024-BraTS-GLI-TrainingData/BraTS-GLI-02517-100/BraTS-GLI-02517-100-t1n.nii.gz,../../DataSet/BraTS2024-BraTS-GLI-TrainingData/BraTS-GLI-02517-100/BraTS-GLI-02517-100-seg.nii.gz,57,119,107,37,72,104,138,97,121,35,34,24
00543-101,../../DataSet/BraTS2024-BraTS-GLI-TrainingData/BraTS-GLI-00543-101/BraTS-GLI-00543-101-t1c.nii.gz,../../DataSet/BraTS2024-BraTS-GLI-TrainingData/BraTS-GLI-00543-101/BraTS-GLI-00543-101-t2w.nii.gz,../../DataSet/BraTS2024-BraTS-GLI-TrainingData/BraTS-GLI-00543-101/BraTS-GLI-00543-101-t2f.nii.gz,../../DataSet/BraTS2024-BraTS-GLI-TrainingData/BraTS-GLI-00543-101/BraTS-GLI-00543-101-t1n.nii.gz,../../DataSet/BraTS2024-BraTS-GLI-TrainingData/BraTS-GLI-00543-101/BraTS-GLI-00543-101-seg.nii.gz,114,142,85,69,141,93,184,55,115,72,91,60
02216-101,../../DataSet/BraTS2024-BraTS-GLI-TrainingData/BraTS-GLI-02216-101/BraTS-GLI-02216-101-t1c.nii.gz,../../DataSet/BraTS2024-BraTS-GLI-TrainingData/BraTS-GLI-02216-101/BraTS-GLI-02216-101-t2w.nii.gz,../../DataSet/BraTS2024-BraTS-GLI-TrainingData/BraTS-GLI-02216-101/BraTS-GLI-02216-101-t2f.nii.gz,../../DataSet/BraTS2024-BraTS-GLI-TrainingData/BraTS-GLI-02216-101/BraTS-GLI-02216-101-t1n.nii.gz,../../DataSet/BraTS2024-BraTS-GLI-TrainingData/BraTS-GLI-02216-101/BraTS-GLI-02216-101-seg.nii.gz,72,154,117,50,88,129,182,91,144,38,53,53
02912-101,../../DataSet/BraTS2024-BraTS-GLI-TrainingData/BraTS-GLI-02912-101/BraTS-GLI-02912-101-t1c.nii.gz,../../DataSet/BraTS2024-BraTS-GLI-TrainingData/BraTS-GLI-02912-101/BraTS-GLI-02912-101-t2w.nii.gz,../../DataSet/BraTS2024-BraTS-GLI-TrainingData/BraTS-GLI-02912-101/BraTS-GLI-02912-101-t2f.nii.gz,../../DataSet/BraTS2024-BraTS-GLI-TrainingData/BraTS-GLI-02912-101/BraTS-GLI-02912-101-t1n.nii.gz,../../DataSet/BraTS2024-BraTS-GLI-TrainingData/BraTS-GLI-02912-101/BraTS-GLI-02912-101-seg.nii.gz,83,106,79,38,132,82,131,63,104,94,49,41
02345-100,../../DataSet/BraTS2024-BraTS-GLI-TrainingData/BraTS-GLI-02345-100/BraTS-GLI-02345-100-t1c.nii.gz,../../DataSet/BraTS2024-BraTS-GLI-TrainingData/BraTS-GLI-02345-100/BraTS-GLI-02345-100-t2w.nii.gz,../../DataSet/BraTS2024-BraTS-GLI-TrainingData/BraTS-GLI-02345-100/BraTS-GLI-02345-100-t2f.nii.gz,../../DataSet/BraTS2024-BraTS-GLI-TrainingData/BraTS-GLI-02345-100/BraTS-GLI-02345-100-t1n.nii.gz,../../DataSet/BraTS2024-BraTS-GLI-TrainingData/BraTS-GLI-02345-100/BraTS-GLI-02345-100-seg.nii.gz,64,123,81,37,92,97,157,53,115,55,60,62
02890-100,../../DataSet/BraTS2024-BraTS-GLI-TrainingData/BraTS-GLI-02890-100/BraTS-GLI-02890-100-t1c.nii.gz,../../DataSet/BraTS2024-BraTS-GLI-TrainingData/BraTS-GLI-02890-100/BraTS-GLI-02890-100-t2w.nii.gz,../../DataSet/BraTS2024-BraTS-GLI-TrainingData/BraTS-GLI-02890-100/BraTS-GLI-02890-100-t2f.nii.gz,../../DataSet/BraTS2024-BraTS-GLI-TrainingData/BraTS-GLI-02890-100/BraTS-GLI-02890-100-t1n.nii.gz,../../DataSet/BraTS2024-BraTS-GLI-TrainingData/BraTS-GLI-02890-100/BraTS-GLI-02890-100-seg.nii.gz,117,134,93,82,148,89,179,49,140,66,90,91
02083-100,../../DataSet/BraTS2024-BraTS-GLI-TrainingData/BraTS-GLI-02083-100/BraTS-GLI-02083-100-t1c.nii.gz,../../DataSet/BraTS2024-BraTS-GLI-TrainingData/BraTS-GLI-02083-100/BraTS-GLI-02083-100-t2w.nii.gz,../../DataSet/BraTS2024-BraTS-GLI-TrainingData/BraTS-GLI-02083-100/BraTS-GLI-02083-100-t2f.nii.gz,../../DataSet/BraTS2024-BraTS-GLI-TrainingData/BraTS-GLI-02083-100/BraTS-GLI-02083-100-t1n.nii.gz,../../DataSet/BraTS2024-BraTS-GLI-TrainingData/BraTS-GLI-02083-100/BraTS-GLI-02083-100-seg.nii.gz,79,81,136,51,122,57,117,111,156,71,60,45
00548-100,../../DataSet/BraTS2024-BraTS-GLI-TrainingData/BraTS-GLI-00548-100/BraTS-GLI-00548-100-t1c.nii.gz,../../DataSet/BraTS2024-BraTS-GLI-TrainingData/BraTS-GLI-00548-100/BraTS-GLI-00548-100-t2w.nii.gz,../../DataSet/BraTS2024-BraTS-GLI-TrainingData/BraTS-GLI-00548-100/BraTS-GLI-00548-100-t2f.nii.gz,../../DataSet/BraTS2024-BraTS-GLI-TrainingData/BraTS-GLI-00548-100/BraTS-GLI-00548-100-t1n.nii.gz,../../DataSet/BraTS2024-BraTS-GLI-TrainingData/BraTS-GLI-00548-100/BraTS-GLI-00548-100-seg.nii.gz,53,123,63,31,75,82,150,47,85,44,68,38
02132-102,../../DataSet/BraTS2024-BraTS-GLI-TrainingData/BraTS-GLI-02132-102/BraTS-GLI-02132-102-t1c.nii.gz,../../DataSet/BraTS2024-BraTS-GLI-TrainingData/BraTS-GLI-02132-102/BraTS-GLI-02132-102-t2w.nii.gz,../../DataSet/BraTS2024-BraTS-GLI-TrainingData/BraTS-GLI-02132-102/BraTS-GLI-02132-102-t2f.nii.gz,../../DataSet/BraTS2024-BraTS-GLI-TrainingData/BraTS-GLI-02132-102/BraTS-GLI-02132-102-t1n.nii.gz,../../DataSet/BraTS2024-BraTS-GLI-TrainingData/BraTS-GLI-02132-102/BraTS-GLI-02132-102-seg.nii.gz,101,133,118,71,126,102,162,89,150,55,60,61
02393-100,../../DataSet/BraTS2024-BraTS-GLI-TrainingData/BraTS-GLI-02393-100/BraTS-GLI-02393-100-t1c.nii.gz,../../DataSet/BraTS2024-BraTS-GLI-TrainingData/BraTS-GLI-02393-100/BraTS-GLI-02393-100-t2w.nii.gz,../../DataSet/BraTS2024-BraTS-GLI-TrainingData/BraTS-GLI-02393-100/BraTS-GLI-02393-100-t2f.nii.gz,../../DataSet/BraTS2024-BraTS-GLI-TrainingData/BraTS-GLI-02393-100/BraTS-GLI-02393-100-t1n.nii.gz,../../DataSet/BraTS2024-BraTS-GLI-TrainingData/BraTS-GLI-02393-100/BraTS-GLI-02393-100-seg.nii.gz,124,131,76,101,145,104,157,55,102,44,53,47
02897-100,../../DataSet/BraTS2024-BraTS-GLI-TrainingData/BraTS-GLI-02897-100/BraTS-GLI-02897-100-t1c.nii.gz,../../DataSet/BraTS2024-BraTS-GLI-TrainingData/BraTS-GLI-02897-100/BraTS-GLI-02897-100-t2w.nii.gz,../../DataSet/BraTS2024-BraTS-GLI-TrainingData/BraTS-GLI-02897-100/BraTS-GLI-02897-100-t2f.nii.gz,../../DataSet/BraTS2024-BraTS-GLI-TrainingData/BraTS-GLI-02897-100/BraTS-GLI-02897-100-t1n.nii.gz,../../DataSet/BraTS2024-BraTS-GLI-TrainingData/BraTS-GLI-02897-100/BraTS-GLI-02897-100-seg.nii.gz,121,125,82,93,148,86,148,56,122,55,62,66
02342-100,../../DataSet/BraTS2024-BraTS-GLI-TrainingData/BraTS-GLI-02342-100/BraTS-GLI-02342-100-t1c.nii.gz,../../DataSet/BraTS2024-BraTS-GLI-TrainingData/BraTS-GLI-02342-100/BraTS-GLI-02342-100-t2w.nii.gz,../../DataSet/BraTS2024-BraTS-GLI-TrainingData/BraTS-GLI-02342-100/BraTS-GLI-02342-100-t2f.nii.gz,../../DataSet/BraTS2024-BraTS-GLI-TrainingData/BraTS-GLI-02342-100/BraTS-GLI-02342-100-t1n.nii.gz,../../DataSet/BraTS2024-BraTS-GLI-TrainingData/BraTS-GLI-02342-100/BraTS-GLI-02342-100-seg.nii.gz,48,117,68,28,88,72,160,48,99,60,88,51
02084-100,../../DataSet/BraTS2024-BraTS-GLI-TrainingData/BraTS-GLI-02084-100/BraTS-GLI-02084-100-t1c.nii.gz,../../DataSet/BraTS2024-BraTS-GLI-TrainingData/BraTS-GLI-02084-100/BraTS-GLI-02084-100-t2w.nii.gz,../../DataSet/BraTS2024-BraTS-GLI-TrainingData/BraTS-GLI-02084-100/BraTS-GLI-02084-100-t2f.nii.gz,../../DataSet/BraTS2024-BraTS-GLI-TrainingData/BraTS-GLI-02084-100/BraTS-GLI-02084-100-t1n.nii.gz,../../DataSet/BraTS2024-BraTS-GLI-TrainingData/BraTS-GLI-02084-100/BraTS-GLI-02084-100-seg.nii.gz,133,83,76,115,152,62,112,55,106,37,50,51
02723-100,../../DataSet/BraTS2024-BraTS-GLI-TrainingData/BraTS-GLI-02723-100/BraTS-GLI-02723-100-t1c.nii.gz,../../DataSet/BraTS2024-BraTS-GLI-TrainingData/BraTS-GLI-02723-100/BraTS-GLI-02723-100-t2w.nii.gz,../../DataSet/BraTS2024-BraTS-GLI-TrainingData/BraTS-GLI-02723-100/BraTS-GLI-02723-100-t2f.nii.gz,../../DataSet/BraTS2024-BraTS-GLI-TrainingData/BraTS-GLI-02723-100/BraTS-GLI-02723-100-t1n.nii.gz,../../DataSet/BraTS2024-BraTS-GLI-TrainingData/BraTS-GLI-02723-100/BraTS-GLI-02723-100-seg.nii.gz,111,81,113,65,147,44,124,64,158,82,80,94
02193-103,../../DataSet/BraTS2024-BraTS-GLI-TrainingData/BraTS-GLI-02193-103/BraTS-GLI-02193-103-t1c.nii.gz,../../DataSet/BraTS2024-BraTS-GLI-TrainingData/BraTS-GLI-02193-103/BraTS-GLI-02193-103-t2w.nii.gz,../../DataSet/BraTS2024-BraTS-GLI-TrainingData/BraTS-GLI-02193-103/BraTS-GLI-02193-103-t2f.nii.gz,../../DataSet/BraTS2024-BraTS-GLI-TrainingData/BraTS-GLI-02193-103/BraTS-GLI-02193-103-t1n.nii.gz,../../DataSet/BraTS2024-BraTS-GLI-TrainingData/BraTS-GLI-02193-103/BraTS-GLI-02193-103-seg.nii.gz,124,81,115,96,153,48,127,79,147,57,79,68
02969-101,../../DataSet/BraTS2024-BraTS-GLI-TrainingData/BraTS-GLI-02969-101/BraTS-GLI-02969-101-t1c.nii.gz,../../DataSet/BraTS2024-BraTS-GLI-TrainingData/BraTS-GLI-02969-101/BraTS-GLI-02969-101-t2w.nii.gz,../../DataSet/BraTS2024-BraTS-GLI-TrainingData/BraTS-GLI-02969-101/BraTS-GLI-02969-101-t2f.nii.gz,../../DataSet/BraTS2024-BraTS-GLI-TrainingData/BraTS-GLI-02969-101/BraTS-GLI-02969-101-t1n.nii.gz,../../DataSet/BraTS2024-BraTS-GLI-TrainingData/BraTS-GLI-02969-101/BraTS-GLI-02969-101-seg.nii.gz,60,87,129,37,98,63,109,104,150,61,46,46
02831-101,../../DataSet/BraTS2024-BraTS-GLI-TrainingData/BraTS-GLI-02831-101/BraTS-GLI-02831-101-t1c.nii.gz,../../DataSet/BraTS2024-BraTS-GLI-TrainingData/BraTS-GLI-02831-101/BraTS-GLI-02831-101-t2w.nii.gz,../../DataSet/BraTS2024-BraTS-GLI-TrainingData/BraTS-GLI-02831-101/BraTS-GLI-02831-101-t2f.nii.gz,../../DataSet/BraTS2024-BraTS-GLI-TrainingData/BraTS-GLI-02831-101/BraTS-GLI-02831-101-t1n.nii.gz,../../DataSet/BraTS2024-BraTS-GLI-TrainingData/BraTS-GLI-02831-101/BraTS-GLI-02831-101-seg.nii.gz,61,52,94,39,80,34,79,69,116,41,45,47
00533-100,../../DataSet/BraTS2024-BraTS-GLI-TrainingData/BraTS-GLI-00533-100/BraTS-GLI-00533-100-t1c.nii.gz,../../DataSet/BraTS2024-BraTS-GLI-TrainingData/BraTS-GLI-00533-100/BraTS-GLI-00533-100-t2w.nii.gz,../../DataSet/BraTS2024-BraTS-GLI-TrainingData/BraTS-GLI-00533-100/BraTS-GLI-00533-100-t2f.nii.gz,../../DataSet/BraTS2024-BraTS-GLI-TrainingData/BraTS-GLI-00533-100/BraTS-GLI-00533-100-t1n.nii.gz,../../DataSet/BraTS2024-BraTS-GLI-TrainingData/BraTS-GLI-00533-100/BraTS-GLI-00533-100-seg.nii.gz,117,61,84,91,150,24,111,59,125,59,87,66
02198-102,../../DataSet/BraTS2024-BraTS-GLI-TrainingData/BraTS-GLI-02198-102/BraTS-GLI-02198-102-t1c.nii.gz,../../DataSet/BraTS2024-BraTS-GLI-TrainingData/BraTS-GLI-02198-102/BraTS-GLI-02198-102-t2w.nii.gz,../../DataSet/BraTS2024-BraTS-GLI-TrainingData/BraTS-GLI-02198-102/BraTS-GLI-02198-102-t2f.nii.gz,../../DataSet/BraTS2024-BraTS-GLI-TrainingData/BraTS-GLI-02198-102/BraTS-GLI-02198-102-t1n.nii.gz,../../DataSet/BraTS2024-BraTS-GLI-TrainingData/BraTS-GLI-02198-102/BraTS-GLI-02198-102-seg.nii.gz,57,66,92,30,119,30,112,63,129,89,82,66
02244-104,../../DataSet/BraTS2024-BraTS-GLI-TrainingData/BraTS-GLI-02244-104/BraTS-GLI-02244-104-t1c.nii.gz,../../DataSet/BraTS2024-BraTS-GLI-TrainingData/BraTS-GLI-02244-104/BraTS-GLI-02244-104-t2w.nii.gz,../../DataSet/BraTS2024-BraTS-GLI-TrainingData/BraTS-GLI-02244-104/BraTS-GLI-02244-104-t2f.nii.gz,../../DataSet/BraTS2024-BraTS-GLI-TrainingData/BraTS-GLI-02244-104/BraTS-GLI-02244-104-t1n.nii.gz,../../DataSet/BraTS2024-BraTS-GLI-TrainingData/BraTS-GLI-02244-104/BraTS-GLI-02244-104-seg.nii.gz,74,145,114,52,93,112,182,74,151,41,70,77
02149-102,../../DataSet/BraTS2024-BraTS-GLI-TrainingData/BraTS-GLI-02149-102/BraTS-GLI-02149-102-t1c.nii.gz,../../DataSet/BraTS2024-BraTS-GLI-TrainingData/BraTS-GLI-02149-102/BraTS-GLI-02149-102-t2w.nii.gz,../../DataSet/BraTS2024-BraTS-GLI-TrainingData/BraTS-GLI-02149-102/BraTS-GLI-02149-102-t2f.nii.gz,../../DataSet/BraTS2024-BraTS-GLI-TrainingData/BraTS-GLI-02149-102/BraTS-GLI-02149-102-t1n.nii.gz,../../DataSet/BraTS2024-BraTS-GLI-TrainingData/BraTS-GLI-02149-102/BraTS-GLI-02149-102-seg.nii.gz,103,81,105,67,124,50,112,70,133,57,62,63
02171-100,../../DataSet/BraTS2024-BraTS-GLI-TrainingData/BraTS-GLI-02171-100/BraTS-GLI-02171-100-t1c.nii.gz,../../DataSet/BraTS2024-BraTS-GLI-TrainingData/BraTS-GLI-02171-100/BraTS-GLI-02171-100-t2w.nii.gz,../../DataSet/BraTS2024-BraTS-GLI-TrainingData/BraTS-GLI-02171-100/BraTS-GLI-02171-100-t2f.nii.gz,../../DataSet/BraTS2024-BraTS-GLI-TrainingData/BraTS-GLI-02171-100/BraTS-GLI-02171-100-t1n.nii.gz,../../DataSet/BraTS2024-BraTS-GLI-TrainingData/BraTS-GLI-02171-100/BraTS-GLI-02171-100-seg.nii.gz,63,158,99,34,92,116,195,68,130,58,79,62
02335-101,../../DataSet/BraTS2024-BraTS-GLI-TrainingData/BraTS-GLI-02335-101/BraTS-GLI-02335-101-t1c.nii.gz,../../DataSet/BraTS2024-BraTS-GLI-TrainingData/BraTS-GLI-02335-101/BraTS-GLI-02335-101-t2w.nii.gz,../../DataSet/BraTS2024-BraTS-GLI-TrainingData/BraTS-GLI-02335-101/BraTS-GLI-02335-101-t2f.nii.gz,../../DataSet/BraTS2024-BraTS-GLI-TrainingData/BraTS-GLI-02335-101/BraTS-GLI-02335-101-t1n.nii.gz,../../DataSet/BraTS2024-BraTS-GLI-TrainingData/BraTS-GLI-02335-101/BraTS-GLI-02335-101-seg.nii.gz,112,94,119,95,137,65,123,98,148,42,58,50
02848-100,../../DataSet/BraTS2024-BraTS-GLI-TrainingData/BraTS-GLI-02848-100/BraTS-GLI-02848-100-t1c.nii.gz,../../DataSet/BraTS2024-BraTS-GLI-TrainingData/BraTS-GLI-02848-100/BraTS-GLI-02848-100-t2w.nii.gz,../../DataSet/BraTS2024-BraTS-GLI-TrainingData/BraTS-GLI-02848-100/BraTS-GLI-02848-100-t2f.nii.gz,../../DataSet/BraTS2024-BraTS-GLI-TrainingData/BraTS-GLI-02848-100/BraTS-GLI-02848-100-t1n.nii.gz,../../DataSet/BraTS2024-BraTS-GLI-TrainingData/BraTS-GLI-02848-100/BraTS-GLI-02848-100-seg.nii.gz,73,87,116,36,126,43,132,84,153,90,89,69
02899-100,../../DataSet/BraTS2024-BraTS-GLI-TrainingData/BraTS-GLI-02899-100/BraTS-GLI-02899-100-t1c.nii.gz,../../DataSet/BraTS2024-BraTS-GLI-TrainingData/BraTS-GLI-02899-100/BraTS-GLI-02899-100-t2w.nii.gz,../../DataSet/BraTS2024-BraTS-GLI-TrainingData/BraTS-GLI-02899-100/BraTS-GLI-02899-100-t2f.nii.gz,../../DataSet/BraTS2024-BraTS-GLI-TrainingData/BraTS-GLI-02899-100/BraTS-GLI-02899-100-t1n.nii.gz,../../DataSet/BraTS2024-BraTS-GLI-TrainingData/BraTS-GLI-02899-100/BraTS-GLI-02899-100-seg.nii.gz,109,106,123,60,145,61,139,85,154,85,78,69
02843-101,../../DataSet/BraTS2024-BraTS-GLI-TrainingData/BraTS-GLI-02843-101/BraTS-GLI-02843-101-t1c.nii.gz,../../DataSet/BraTS2024-BraTS-GLI-TrainingData/BraTS-GLI-02843-101/BraTS-GLI-02843-101-t2w.nii.gz,../../DataSet/BraTS2024-BraTS-GLI-TrainingData/BraTS-GLI-02843-101/BraTS-GLI-02843-101-t2f.nii.gz,../../DataSet/BraTS2024-BraTS-GLI-TrainingData/BraTS-GLI-02843-101/BraTS-GLI-02843-101-t1n.nii.gz,../../DataSet/BraTS2024-BraTS-GLI-TrainingData/BraTS-GLI-02843-101/BraTS-GLI-02843-101-seg.nii.gz,109,82,125,97,133,59,105,103,148,36,46,45
02103-100,../../DataSet/BraTS2024-BraTS-GLI-TrainingData/BraTS-GLI-02103-100/BraTS-GLI-02103-100-t1c.nii.gz,../../DataSet/BraTS2024-BraTS-GLI-TrainingData/BraTS-GLI-02103-100/BraTS-GLI-02103-100-t2w.nii.gz,../../DataSet/BraTS2024-BraTS-GLI-TrainingData/BraTS-GLI-02103-100/BraTS-GLI-02103-100-t2f.nii.gz,../../DataSet/BraTS2024-BraTS-GLI-TrainingData/BraTS-GLI-02103-100/BraTS-GLI-02103-100-t1n.nii.gz,../../DataSet/BraTS2024-BraTS-GLI-TrainingData/BraTS-GLI-02103-100/BraTS-GLI-02103-100-seg.nii.gz,107,147,70,82,133,118,178,47,101,51,60,54
02081-101,../../DataSet/BraTS2024-BraTS-GLI-TrainingData/BraTS-GLI-02081-101/BraTS-GLI-02081-101-t1c.nii.gz,../../DataSet/BraTS2024-BraTS-GLI-TrainingData/BraTS-GLI-02081-101/BraTS-GLI-02081-101-t2w.nii.gz,../../DataSet/BraTS2024-BraTS-GLI-TrainingData/BraTS-GLI-02081-101/BraTS-GLI-02081-101-t2f.nii.gz,../../DataSet/BraTS2024-BraTS-GLI-TrainingData/BraTS-GLI-02081-101/BraTS-GLI-02081-101-t1n.nii.gz,../../DataSet/BraTS2024-BraTS-GLI-TrainingData/BraTS-GLI-02081-101/BraTS-GLI-02081-101-seg.nii.gz,107,169,86,73,135,138,197,54,131,62,59,77
02072-105,../../DataSet/BraTS2024-BraTS-GLI-TrainingData/BraTS-GLI-02072-105/BraTS-GLI-02072-105-t1c.nii.gz,../../DataSet/BraTS2024-BraTS-GLI-TrainingData/BraTS-GLI-02072-105/BraTS-GLI-02072-105-t2w.nii.gz,../../DataSet/BraTS2024-BraTS-GLI-TrainingData/BraTS-GLI-02072-105/BraTS-GLI-02072-105-t2f.nii.gz,../../DataSet/BraTS2024-BraTS-GLI-TrainingData/BraTS-GLI-02072-105/BraTS-GLI-02072-105-t1n.nii.gz,../../DataSet/BraTS2024-BraTS-GLI-TrainingData/BraTS-GLI-02072-105/BraTS-GLI-02072-105-seg.nii.gz,50,108,85,29,79,68,144,51,128,50,76,77
02910-100,../../DataSet/BraTS2024-BraTS-GLI-TrainingData/BraTS-GLI-02910-100/BraTS-GLI-02910-100-t1c.nii.gz,../../DataSet/BraTS2024-BraTS-GLI-TrainingData/BraTS-GLI-02910-100/BraTS-GLI-02910-100-t2w.nii.gz,../../DataSet/BraTS2024-BraTS-GLI-TrainingData/BraTS-GLI-02910-100/BraTS-GLI-02910-100-t2f.nii.gz,../../DataSet/BraTS2024-BraTS-GLI-TrainingData/BraTS-GLI-02910-100/BraTS-GLI-02910-100-t1n.nii.gz,../../DataSet/BraTS2024-BraTS-GLI-TrainingData/BraTS-GLI-02910-100/BraTS-GLI-02910-100-seg.nii.gz,126,129,77,97,152,93,165,52,103,55,72,51
02780-100,../../DataSet/BraTS2024-BraTS-GLI-TrainingData/BraTS-GLI-02780-100/BraTS-GLI-02780-100-t1c.nii.gz,../../DataSet/BraTS2024-BraTS-GLI-TrainingData/BraTS-GLI-02780-100/BraTS-GLI-02780-100-t2w.nii.gz,../../DataSet/BraTS2024-BraTS-GLI-TrainingData/BraTS-GLI-02780-100/BraTS-GLI-02780-100-t2f.nii.gz,../../DataSet/BraTS2024-BraTS-GLI-TrainingData/BraTS-GLI-02780-100/BraTS-GLI-02780-100-t1n.nii.gz,../../DataSet/BraTS2024-BraTS-GLI-TrainingData/BraTS-GLI-02780-100/BraTS-GLI-02780-100-seg.nii.gz,50,116,61,33,74,91,141,46,80,41,50,34
02834-100,../../DataSet/BraTS2024-BraTS-GLI-TrainingData/BraTS-GLI-02834-100/BraTS-GLI-02834-100-t1c.nii.gz,../../DataSet/BraTS2024-BraTS-GLI-TrainingData/BraTS-GLI-02834-100/BraTS-GLI-02834-100-t2w.nii.gz,../../DataSet/BraTS2024-BraTS-GLI-TrainingData/BraTS-GLI-02834-100/BraTS-GLI-02834-100-t2f.nii.gz,../../DataSet/BraTS2024-BraTS-GLI-TrainingData/BraTS-GLI-02834-100/BraTS-GLI-02834-100-t1n.nii.gz,../../DataSet/BraTS2024-BraTS-GLI-TrainingData/BraTS-GLI-02834-100/BraTS-GLI-02834-100-seg.nii.gz,79,115,109,51,123,74,152,81,136,72,78,55
02330-100,../../DataSet/BraTS2024-BraTS-GLI-TrainingData/BraTS-GLI-02330-100/BraTS-GLI-02330-100-t1c.nii.gz,../../DataSet/BraTS2024-BraTS-GLI-TrainingData/BraTS-GLI-02330-100/BraTS-GLI-02330-100-t2w.nii.gz,../../DataSet/BraTS2024-BraTS-GLI-TrainingData/BraTS-GLI-02330-100/BraTS-GLI-02330-100-t2f.nii.gz,../../DataSet/BraTS2024-BraTS-GLI-TrainingData/BraTS-GLI-02330-100/BraTS-GLI-02330-100-t1n.nii.gz,../../DataSet/BraTS2024-BraTS-GLI-TrainingData/BraTS-GLI-02330-100/BraTS-GLI-02330-100-seg.nii.gz,81,65,98,46,120,31,97,72,127,74,66,55
02751-100,../../DataSet/BraTS2024-BraTS-GLI-TrainingData/BraTS-GLI-02751-100/BraTS-GLI-02751-100-t1c.nii.gz,../../DataSet/BraTS2024-BraTS-GLI-TrainingData/BraTS-GLI-02751-100/BraTS-GLI-02751-100-t2w.nii.gz,../../DataSet/BraTS2024-BraTS-GLI-TrainingData/BraTS-GLI-02751-100/BraTS-GLI-02751-100-t2f.nii.gz,../../DataSet/BraTS2024-BraTS-GLI-TrainingData/BraTS-GLI-02751-100/BraTS-GLI-02751-100-t1n.nii.gz,../../DataSet/BraTS2024-BraTS-GLI-TrainingData/BraTS-GLI-02751-100/BraTS-GLI-02751-100-seg.nii.gz,54,115,118,38,76,91,146,99,132,38,55,33
02174-101,../../DataSet/BraTS2024-BraTS-GLI-TrainingData/BraTS-GLI-02174-101/BraTS-GLI-02174-101-t1c.nii.gz,../../DataSet/BraTS2024-BraTS-GLI-TrainingData/BraTS-GLI-02174-101/BraTS-GLI-02174-101-t2w.nii.gz,../../DataSet/BraTS2024-BraTS-GLI-TrainingData/BraTS-GLI-02174-101/BraTS-GLI-02174-101-t2f.nii.gz,../../DataSet/BraTS2024-BraTS-GLI-TrainingData/BraTS-GLI-02174-101/BraTS-GLI-02174-101-t1n.nii.gz,../../DataSet/BraTS2024-BraTS-GLI-TrainingData/BraTS-GLI-02174-101/BraTS-GLI-02174-101-seg.nii.gz,109,122,119,60,141,80,161,85,150,81,81,65
02196-102,../../DataSet/BraTS2024-BraTS-GLI-TrainingData/BraTS-GLI-02196-102/BraTS-GLI-02196-102-t1c.nii.gz,../../DataSet/BraTS2024-BraTS-GLI-TrainingData/BraTS-GLI-02196-102/BraTS-GLI-02196-102-t2w.nii.gz,../../DataSet/BraTS2024-BraTS-GLI-TrainingData/BraTS-GLI-02196-102/BraTS-GLI-02196-102-t2f.nii.gz,../../DataSet/BraTS2024-BraTS-GLI-TrainingData/BraTS-GLI-02196-102/BraTS-GLI-02196-102-t1n.nii.gz,../../DataSet/BraTS2024-BraTS-GLI-TrainingData/BraTS-GLI-02196-102/BraTS-GLI-02196-102-seg.nii.gz,83,155,105,43,124,113,191,69,140,81,78,71
02609-100,../../DataSet/BraTS2024-BraTS-GLI-TrainingData/BraTS-GLI-02609-100/BraTS-GLI-02609-100-t1c.nii.gz,../../DataSet/BraTS2024-BraTS-GLI-TrainingData/BraTS-GLI-02609-100/BraTS-GLI-02609-100-t2w.nii.gz,../../DataSet/BraTS2024-BraTS-GLI-TrainingData/BraTS-GLI-02609-100/BraTS-GLI-02609-100-t2f.nii.gz,../../DataSet/BraTS2024-BraTS-GLI-TrainingData/BraTS-GLI-02609-100/BraTS-GLI-02609-100-t1n.nii.gz,../../DataSet/BraTS2024-BraTS-GLI-TrainingData/BraTS-GLI-02609-100/BraTS-GLI-02609-100-seg.nii.gz,108,94,88,92,124,58,153,64,123,32,95,59
03049-100,../../DataSet/BraTS2024-BraTS-GLI-TrainingData/BraTS-GLI-03049-100/BraTS-GLI-03049-100-t1c.nii.gz,../../DataSet/BraTS2024-BraTS-GLI-TrainingData/BraTS-GLI-03049-100/BraTS-GLI-03049-100-t2w.nii.gz,../../DataSet/BraTS2024-BraTS-GLI-TrainingData/BraTS-GLI-03049-100/BraTS-GLI-03049-100-t2f.nii.gz,../../DataSet/BraTS2024-BraTS-GLI-TrainingData/BraTS-GLI-03049-100/BraTS-GLI-03049-100-t1n.nii.gz,../../DataSet/BraTS2024-BraTS-GLI-TrainingData/BraTS-GLI-03049-100/BraTS-GLI-03049-100-seg.nii.gz,124,111,74,100,150,77,135,53,98,50,58,45
02833-100,../../DataSet/BraTS2024-BraTS-GLI-TrainingData/BraTS-GLI-02833-100/BraTS-GLI-02833-100-t1c.nii.gz,../../DataSet/BraTS2024-BraTS-GLI-TrainingData/BraTS-GLI-02833-100/BraTS-GLI-02833-100-t2w.nii.gz,../../DataSet/BraTS2024-BraTS-GLI-TrainingData/BraTS-GLI-02833-100/BraTS-GLI-02833-100-t2f.nii.gz,../../DataSet/BraTS2024-BraTS-GLI-TrainingData/BraTS-GLI-02833-100/BraTS-GLI-02833-100-t1n.nii.gz,../../DataSet/BraTS2024-BraTS-GLI-TrainingData/BraTS-GLI-02833-100/BraTS-GLI-02833-100-seg.nii.gz,69,140,80,37,126,83,178,46,126,89,95,80
02337-100,../../DataSet/BraTS2024-BraTS-GLI-TrainingData/BraTS-GLI-02337-100/BraTS-GLI-02337-100-t1c.nii.gz,../../DataSet/BraTS2024-BraTS-GLI-TrainingData/BraTS-GLI-02337-100/BraTS-GLI-02337-100-t2w.nii.gz,../../DataSet/BraTS2024-BraTS-GLI-TrainingData/BraTS-GLI-02337-100/BraTS-GLI-02337-100-t2f.nii.gz,../../DataSet/BraTS2024-BraTS-GLI-TrainingData/BraTS-GLI-02337-100/BraTS-GLI-02337-100-t1n.nii.gz,../../DataSet/BraTS2024-BraTS-GLI-TrainingData/BraTS-GLI-02337-100/BraTS-GLI-02337-100-seg.nii.gz,114,153,110,69,145,115,193,76,142,76,78,66
02756-100,../../DataSet/BraTS2024-BraTS-GLI-TrainingData/BraTS-GLI-02756-100/BraTS-GLI-02756-100-t1c.nii.gz,../../DataSet/BraTS2024-BraTS-GLI-TrainingData/BraTS-GLI-02756-100/BraTS-GLI-02756-100-t2w.nii.gz,../../DataSet/BraTS2024-BraTS-GLI-TrainingData/BraTS-GLI-02756-100/BraTS-GLI-02756-100-t2f.nii.gz,../../DataSet/BraTS2024-BraTS-GLI-TrainingData/BraTS-GLI-02756-100/BraTS-GLI-02756-100-t1n.nii.gz,../../DataSet/BraTS2024-BraTS-GLI-TrainingData/BraTS-GLI-02756-100/BraTS-GLI-02756-100-seg.nii.gz,55,133,90,36,87,81,162,70,120,51,81,50
02838-101,../../DataSet/BraTS2024-BraTS-GLI-TrainingData/BraTS-GLI-02838-101/BraTS-GLI-02838-101-t1c.nii.gz,../../DataSet/BraTS2024-BraTS-GLI-TrainingData/BraTS-GLI-02838-101/BraTS-GLI-02838-101-t2w.nii.gz,../../DataSet/BraTS2024-BraTS-GLI-TrainingData/BraTS-GLI-02838-101/BraTS-GLI-02838-101-t2f.nii.gz,../../DataSet/BraTS2024-BraTS-GLI-TrainingData/BraTS-GLI-02838-101/BraTS-GLI-02838-101-t1n.nii.gz,../../DataSet/BraTS2024-BraTS-GLI-TrainingData/BraTS-GLI-02838-101/BraTS-GLI-02838-101-seg.nii.gz,128,139,100,104,152,100,173,62,130,48,73,68
02178-100,../../DataSet/BraTS2024-BraTS-GLI-TrainingData/BraTS-GLI-02178-100/BraTS-GLI-02178-100-t1c.nii.gz,../../DataSet/BraTS2024-BraTS-GLI-TrainingData/BraTS-GLI-02178-100/BraTS-GLI-02178-100-t2w.nii.gz,../../DataSet/BraTS2024-BraTS-GLI-TrainingData/BraTS-GLI-02178-100/BraTS-GLI-02178-100-t2f.nii.gz,../../DataSet/BraTS2024-BraTS-GLI-TrainingData/BraTS-GLI-02178-100/BraTS-GLI-02178-100-t1n.nii.gz,../../DataSet/BraTS2024-BraTS-GLI-TrainingData/BraTS-GLI-02178-100/BraTS-GLI-02178-100-seg.nii.gz,111,129,121,94,132,83,164,88,149,38,81,61
00008-101,../../DataSet/BraTS2024-BraTS-GLI-TrainingData/BraTS-GLI-00008-101/BraTS-GLI-00008-101-t1c.nii.gz,../../DataSet/BraTS2024-BraTS-GLI-TrainingData/BraTS-GLI-00008-101/BraTS-GLI-00008-101-t2w.nii.gz,../../DataSet/BraTS2024-BraTS-GLI-TrainingData/BraTS-GLI-00008-101/BraTS-GLI-00008-101-t2f.nii.gz,../../DataSet/BraTS2024-BraTS-GLI-TrainingData/BraTS-GLI-00008-101/BraTS-GLI-00008-101-t1n.nii.gz,../../DataSet/BraTS2024-BraTS-GLI-TrainingData/BraTS-GLI-00008-101/BraTS-GLI-00008-101-seg.nii.gz,50,66,78,30,74,38,95,56,100,44,57,44
00469-101,../../DataSet/BraTS2024-BraTS-GLI-TrainingData/BraTS-GLI-00469-101/BraTS-GLI-00469-101-t1c.nii.gz,../../DataSet/BraTS2024-BraTS-GLI-TrainingData/BraTS-GLI-00469-101/BraTS-GLI-00469-101-t2w.nii.gz,../../DataSet/BraTS2024-BraTS-GLI-TrainingData/BraTS-GLI-00469-101/BraTS-GLI-00469-101-t2f.nii.gz,../../DataSet/BraTS2024-BraTS-GLI-TrainingData/BraTS-GLI-00469-101/BraTS-GLI-00469-101-t1n.nii.gz,../../DataSet/BraTS2024-BraTS-GLI-TrainingData/BraTS-GLI-00469-101/BraTS-GLI-00469-101-seg.nii.gz,120,78,106,100,152,43,116,82,135,52,73,53
02218-101,../../DataSet/BraTS2024-BraTS-GLI-TrainingData/BraTS-GLI-02218-101/BraTS-GLI-02218-101-t1c.nii.gz,../../DataSet/BraTS2024-BraTS-GLI-TrainingData/BraTS-GLI-02218-101/BraTS-GLI-02218-101-t2w.nii.gz,../../DataSet/BraTS2024-BraTS-GLI-TrainingData/BraTS-GLI-02218-101/BraTS-GLI-02218-101-t2f.nii.gz,../../DataSet/BraTS2024-BraTS-GLI-TrainingData/BraTS-GLI-02218-101/BraTS-GLI-02218-101-t1n.nii.gz,../../DataSet/BraTS2024-BraTS-GLI-TrainingData/BraTS-GLI-02218-101/BraTS-GLI-02218-101-seg.nii.gz,123,129,75,104,146,99,154,54,103,42,55,49
02086-101,../../DataSet/BraTS2024-BraTS-GLI-TrainingData/BraTS-GLI-02086-101/BraTS-GLI-02086-101-t1c.nii.gz,../../DataSet/BraTS2024-BraTS-GLI-TrainingData/BraTS-GLI-02086-101/BraTS-GLI-02086-101-t2w.nii.gz,../../DataSet/BraTS2024-BraTS-GLI-TrainingData/BraTS-GLI-02086-101/BraTS-GLI-02086-101-t2f.nii.gz,../../DataSet/BraTS2024-BraTS-GLI-TrainingData/BraTS-GLI-02086-101/BraTS-GLI-02086-101-t1n.nii.gz,../../DataSet/BraTS2024-BraTS-GLI-TrainingData/BraTS-GLI-02086-101/BraTS-GLI-02086-101-seg.nii.gz,127,93,112,94,152,56,134,77,152,58,78,75
02895-101,../../DataSet/BraTS2024-BraTS-GLI-TrainingData/BraTS-GLI-02895-101/BraTS-GLI-02895-101-t1c.nii.gz,../../DataSet/BraTS2024-BraTS-GLI-TrainingData/BraTS-GLI-02895-101/BraTS-GLI-02895-101-t2w.nii.gz,../../DataSet/BraTS2024-BraTS-GLI-TrainingData/BraTS-GLI-02895-101/BraTS-GLI-02895-101-t2f.nii.gz,../../DataSet/BraTS2024-BraTS-GLI-TrainingData/BraTS-GLI-02895-101/BraTS-GLI-02895-101-t1n.nii.gz,../../DataSet/BraTS2024-BraTS-GLI-TrainingData/BraTS-GLI-02895-101/BraTS-GLI-02895-101-seg.nii.gz,101,99,120,91,115,78,122,100,154,24,44,54
02326-100,../../DataSet/BraTS2024-BraTS-GLI-TrainingData/BraTS-GLI-02326-100/BraTS-GLI-02326-100-t1c.nii.gz,../../DataSet/BraTS2024-BraTS-GLI-TrainingData/BraTS-GLI-02326-100/BraTS-GLI-02326-100-t2w.nii.gz,../../DataSet/BraTS2024-BraTS-GLI-TrainingData/BraTS-GLI-02326-100/BraTS-GLI-02326-100-t2f.nii.gz,../../DataSet/BraTS2024-BraTS-GLI-TrainingData/BraTS-GLI-02326-100/BraTS-GLI-02326-100-t1n.nii.gz,../../DataSet/BraTS2024-BraTS-GLI-TrainingData/BraTS-GLI-02326-100/BraTS-GLI-02326-100-seg.nii.gz,50,120,73,26,77,85,151,50,136,51,66,86
02747-100,../../DataSet/BraTS2024-BraTS-GLI-TrainingData/BraTS-GLI-02747-100/BraTS-GLI-02747-100-t1c.nii.gz,../../DataSet/BraTS2024-BraTS-GLI-TrainingData/BraTS-GLI-02747-100/BraTS-GLI-02747-100-t2w.nii.gz,../../DataSet/BraTS2024-BraTS-GLI-TrainingData/BraTS-GLI-02747-100/BraTS-GLI-02747-100-t2f.nii.gz,../../DataSet/BraTS2024-BraTS-GLI-TrainingData/BraTS-GLI-02747-100/BraTS-GLI-02747-100-t1n.nii.gz,../../DataSet/BraTS2024-BraTS-GLI-TrainingData/BraTS-GLI-02747-100/BraTS-GLI-02747-100-seg.nii.gz,76,157,103,56,98,101,196,68,137,42,95,69
02796-100,../../DataSet/BraTS2024-BraTS-GLI-TrainingData/BraTS-GLI-02796-100/BraTS-GLI-02796-100-t1c.nii.gz,../../DataSet/BraTS2024-BraTS-GLI-TrainingData/BraTS-GLI-02796-100/BraTS-GLI-02796-100-t2w.nii.gz,../../DataSet/BraTS2024-BraTS-GLI-TrainingData/BraTS-GLI-02796-100/BraTS-GLI-02796-100-t2f.nii.gz,../../DataSet/BraTS2024-BraTS-GLI-TrainingData/BraTS-GLI-02796-100/BraTS-GLI-02796-100-t1n.nii.gz,../../DataSet/BraTS2024-BraTS-GLI-TrainingData/BraTS-GLI-02796-100/BraTS-GLI-02796-100-seg.nii.gz,119,87,120,96,151,47,136,91,149,55,89,58
02115-100,../../DataSet/BraTS2024-BraTS-GLI-TrainingData/BraTS-GLI-02115-100/BraTS-GLI-02115-100-t1c.nii.gz,../../DataSet/BraTS2024-BraTS-GLI-TrainingData/BraTS-GLI-02115-100/BraTS-GLI-02115-100-t2w.nii.gz,../../DataSet/BraTS2024-BraTS-GLI-TrainingData/BraTS-GLI-02115-100/BraTS-GLI-02115-100-t2f.nii.gz,../../DataSet/BraTS2024-BraTS-GLI-TrainingData/BraTS-GLI-02115-100/BraTS-GLI-02115-100-t1n.nii.gz,../../DataSet/BraTS2024-BraTS-GLI-TrainingData/BraTS-GLI-02115-100/BraTS-GLI-02115-100-seg.nii.gz,48,63,67,37,59,50,78,55,80,22,28,25
02884-101,../../DataSet/BraTS2024-BraTS-GLI-TrainingData/BraTS-GLI-02884-101/BraTS-GLI-02884-101-t1c.nii.gz,../../DataSet/BraTS2024-BraTS-GLI-TrainingData/BraTS-GLI-02884-101/BraTS-GLI-02884-101-t2w.nii.gz,../../DataSet/BraTS2024-BraTS-GLI-TrainingData/BraTS-GLI-02884-101/BraTS-GLI-02884-101-t2f.nii.gz,../../DataSet/BraTS2024-BraTS-GLI-TrainingData/BraTS-GLI-02884-101/BraTS-GLI-02884-101-t1n.nii.gz,../../DataSet/BraTS2024-BraTS-GLI-TrainingData/BraTS-GLI-02884-101/BraTS-GLI-02884-101-seg.nii.gz,61,57,85,31,95,28,111,50,135,64,83,85
00557-100,../../DataSet/BraTS2024-BraTS-GLI-TrainingData/BraTS-GLI-00557-100/BraTS-GLI-00557-100-t1c.nii.gz,../../DataSet/BraTS2024-BraTS-GLI-TrainingData/BraTS-GLI-00557-100/BraTS-GLI-00557-100-t2w.nii.gz,../../DataSet/BraTS2024-BraTS-GLI-TrainingData/BraTS-GLI-00557-100/BraTS-GLI-00557-100-t2f.nii.gz,../../DataSet/BraTS2024-BraTS-GLI-TrainingData/BraTS-GLI-00557-100/BraTS-GLI-00557-100-t1n.nii.gz,../../DataSet/BraTS2024-BraTS-GLI-TrainingData/BraTS-GLI-00557-100/BraTS-GLI-00557-100-seg.nii.gz,63,110,108,33,90,62,153,76,137,57,91,61
02855-101,../../DataSet/BraTS2024-BraTS-GLI-TrainingData/BraTS-GLI-02855-101/BraTS-GLI-02855-101-t1c.nii.gz,../../DataSet/BraTS2024-BraTS-GLI-TrainingData/BraTS-GLI-02855-101/BraTS-GLI-02855-101-t2w.nii.gz,../../DataSet/BraTS2024-BraTS-GLI-TrainingData/BraTS-GLI-02855-101/BraTS-GLI-02855-101-t2f.nii.gz,../../DataSet/BraTS2024-BraTS-GLI-TrainingData/BraTS-GLI-02855-101/BraTS-GLI-02855-101-t1n.nii.gz,../../DataSet/BraTS2024-BraTS-GLI-TrainingData/BraTS-GLI-02855-101/BraTS-GLI-02855-101-seg.nii.gz,72,65,96,48,116,38,119,59,124,68,81,65
02209-101,../../DataSet/BraTS2024-BraTS-GLI-TrainingData/BraTS-GLI-02209-101/BraTS-GLI-02209-101-t1c.nii.gz,../../DataSet/BraTS2024-BraTS-GLI-TrainingData/BraTS-GLI-02209-101/BraTS-GLI-02209-101-t2w.nii.gz,../../DataSet/BraTS2024-BraTS-GLI-TrainingData/BraTS-GLI-02209-101/BraTS-GLI-02209-101-t2f.nii.gz,../../DataSet/BraTS2024-BraTS-GLI-TrainingData/BraTS-GLI-02209-101/BraTS-GLI-02209-101-t1n.nii.gz,../../DataSet/BraTS2024-BraTS-GLI-TrainingData/BraTS-GLI-02209-101/BraTS-GLI-02209-101-seg.nii.gz,55,140,101,33,83,107,176,64,138,50,69,74
02112-100,../../DataSet/BraTS2024-BraTS-GLI-TrainingData/BraTS-GLI-02112-100/BraTS-GLI-02112-100-t1c.nii.gz,../../DataSet/BraTS2024-BraTS-GLI-TrainingData/BraTS-GLI-02112-100/BraTS-GLI-02112-100-t2w.nii.gz,../../DataSet/BraTS2024-BraTS-GLI-TrainingData/BraTS-GLI-02112-100/BraTS-GLI-02112-100-t2f.nii.gz,../../DataSet/BraTS2024-BraTS-GLI-TrainingData/BraTS-GLI-02112-100/BraTS-GLI-02112-100-t1n.nii.gz,../../DataSet/BraTS2024-BraTS-GLI-TrainingData/BraTS-GLI-02112-100/BraTS-GLI-02112-100-seg.nii.gz,66,62,103,40,89,32,95,68,139,49,63,71
02901-100,../../DataSet/BraTS2024-BraTS-GLI-TrainingData/BraTS-GLI-02901-100/BraTS-GLI-02901-100-t1c.nii.gz,../../DataSet/BraTS2024-BraTS-GLI-TrainingData/BraTS-GLI-02901-100/BraTS-GLI-02901-100-t2w.nii.gz,../../DataSet/BraTS2024-BraTS-GLI-TrainingData/BraTS-GLI-02901-100/BraTS-GLI-02901-100-t2f.nii.gz,../../DataSet/BraTS2024-BraTS-GLI-TrainingData/BraTS-GLI-02901-100/BraTS-GLI-02901-100-t1n.nii.gz,../../DataSet/BraTS2024-BraTS-GLI-TrainingData/BraTS-GLI-02901-100/BraTS-GLI-02901-100-seg.nii.gz,59,127,123,44,76,106,145,109,140,32,39,31
02205-100,../../DataSet/BraTS2024-BraTS-GLI-TrainingData/BraTS-GLI-02205-100/BraTS-GLI-02205-100-t1c.nii.gz,../../DataSet/BraTS2024-BraTS-GLI-TrainingData/BraTS-GLI-02205-100/BraTS-GLI-02205-100-t2w.nii.gz,../../DataSet/BraTS2024-BraTS-GLI-TrainingData/BraTS-GLI-02205-100/BraTS-GLI-02205-100-t2f.nii.gz,../../DataSet/BraTS2024-BraTS-GLI-TrainingData/BraTS-GLI-02205-100/BraTS-GLI-02205-100-t1n.nii.gz,../../DataSet/BraTS2024-BraTS-GLI-TrainingData/BraTS-GLI-02205-100/BraTS-GLI-02205-100-seg.nii.gz,101,142,116,74,119,116,176,82,150,45,60,68
02664-100,../../DataSet/BraTS2024-BraTS-GLI-TrainingData/BraTS-GLI-02664-100/BraTS-GLI-02664-100-t1c.nii.gz,../../DataSet/BraTS2024-BraTS-GLI-TrainingData/BraTS-GLI-02664-100/BraTS-GLI-02664-100-t2w.nii.gz,../../DataSet/BraTS2024-BraTS-GLI-TrainingData/BraTS-GLI-02664-100/BraTS-GLI-02664-100-t2f.nii.gz,../../DataSet/BraTS2024-BraTS-GLI-TrainingData/BraTS-GLI-02664-100/BraTS-GLI-02664-100-t1n.nii.gz,../../DataSet/BraTS2024-BraTS-GLI-TrainingData/BraTS-GLI-02664-100/BraTS-GLI-02664-100-seg.nii.gz,107,160,99,60,144,118,198,62,143,84,80,81
03024-100,../../DataSet/BraTS2024-BraTS-GLI-TrainingData/BraTS-GLI-03024-100/BraTS-GLI-03024-100-t1c.nii.gz,../../DataSet/BraTS2024-BraTS-GLI-TrainingData/BraTS-GLI-03024-100/BraTS-GLI-03024-100-t2w.nii.gz,../../DataSet/BraTS2024-BraTS-GLI-TrainingData/BraTS-GLI-03024-100/BraTS-GLI-03024-100-t2f.nii.gz,../../DataSet/BraTS2024-BraTS-GLI-TrainingData/BraTS-GLI-03024-100/BraTS-GLI-03024-100-t1n.nii.gz,../../DataSet/BraTS2024-BraTS-GLI-TrainingData/BraTS-GLI-03024-100/BraTS-GLI-03024-100-seg.nii.gz,124,97,124,106,147,72,125,97,149,41,53,52
02072-102,../../DataSet/BraTS2024-BraTS-GLI-TrainingData/BraTS-GLI-02072-102/BraTS-GLI-02072-102-t1c.nii.gz,../../DataSet/BraTS2024-BraTS-GLI-TrainingData/BraTS-GLI-02072-102/BraTS-GLI-02072-102-t2w.nii.gz,../../DataSet/BraTS2024-BraTS-GLI-TrainingData/BraTS-GLI-02072-102/BraTS-GLI-02072-102-t2f.nii.gz,../../DataSet/BraTS2024-BraTS-GLI-TrainingData/BraTS-GLI-02072-102/BraTS-GLI-02072-102-t1n.nii.gz,../../DataSet/BraTS2024-BraTS-GLI-TrainingData/BraTS-GLI-02072-102/BraTS-GLI-02072-102-seg.nii.gz,52,101,99,29,89,53,142,56,147,60,89,91
02236-103,../../DataSet/BraTS2024-BraTS-GLI-TrainingData/BraTS-GLI-02236-103/BraTS-GLI-02236-103-t1c.nii.gz,../../DataSet/BraTS2024-BraTS-GLI-TrainingData/BraTS-GLI-02236-103/BraTS-GLI-02236-103-t2w.nii.gz,../../DataSet/BraTS2024-BraTS-GLI-TrainingData/BraTS-GLI-02236-103/BraTS-GLI-02236-103-t2f.nii.gz,../../DataSet/BraTS2024-BraTS-GLI-TrainingData/BraTS-GLI-02236-103/BraTS-GLI-02236-103-t1n.nii.gz,../../DataSet/BraTS2024-BraTS-GLI-TrainingData/BraTS-GLI-02236-103/BraTS-GLI-02236-103-seg.nii.gz,129,129,94,111,148,103,152,74,113,37,49,39
02859-100,../../DataSet/BraTS2024-BraTS-GLI-TrainingData/BraTS-GLI-02859-100/BraTS-GLI-02859-100-t1c.nii.gz,../../DataSet/BraTS2024-BraTS-GLI-TrainingData/BraTS-GLI-02859-100/BraTS-GLI-02859-100-t2w.nii.gz,../../DataSet/BraTS2024-BraTS-GLI-TrainingData/BraTS-GLI-02859-100/BraTS-GLI-02859-100-t2f.nii.gz,../../DataSet/BraTS2024-BraTS-GLI-TrainingData/BraTS-GLI-02859-100/BraTS-GLI-02859-100-t1n.nii.gz,../../DataSet/BraTS2024-BraTS-GLI-TrainingData/BraTS-GLI-02859-100/BraTS-GLI-02859-100-seg.nii.gz,94,108,110,56,125,52,148,79,144,69,96,65
02241-102,../../DataSet/BraTS2024-BraTS-GLI-TrainingData/BraTS-GLI-02241-102/BraTS-GLI-02241-102-t1c.nii.gz,../../DataSet/BraTS2024-BraTS-GLI-TrainingData/BraTS-GLI-02241-102/BraTS-GLI-02241-102-t2w.nii.gz,../../DataSet/BraTS2024-BraTS-GLI-TrainingData/BraTS-GLI-02241-102/BraTS-GLI-02241-102-t2f.nii.gz,../../DataSet/BraTS2024-BraTS-GLI-TrainingData/BraTS-GLI-02241-102/BraTS-GLI-02241-102-t1n.nii.gz,../../DataSet/BraTS2024-BraTS-GLI-TrainingData/BraTS-GLI-02241-102/BraTS-GLI-02241-102-seg.nii.gz,113,156,98,76,142,113,198,61,141,66,85,80
02196-105,../../DataSet/BraTS2024-BraTS-GLI-TrainingData/BraTS-GLI-02196-105/BraTS-GLI-02196-105-t1c.nii.gz,../../DataSet/BraTS2024-BraTS-GLI-TrainingData/BraTS-GLI-02196-105/BraTS-GLI-02196-105-t2w.nii.gz,../../DataSet/BraTS2024-BraTS-GLI-TrainingData/BraTS-GLI-02196-105/BraTS-GLI-02196-105-t2f.nii.gz,../../DataSet/BraTS2024-BraTS-GLI-TrainingData/BraTS-GLI-02196-105/BraTS-GLI-02196-105-t1n.nii.gz,../../DataSet/BraTS2024-BraTS-GLI-TrainingData/BraTS-GLI-02196-105/BraTS-GLI-02196-105-seg.nii.gz,86,150,106,40,131,108,193,62,148,91,85,86
02165-101,../../DataSet/BraTS2024-BraTS-GLI-TrainingData/BraTS-GLI-02165-101/BraTS-GLI-02165-101-t1c.nii.gz,../../DataSet/BraTS2024-BraTS-GLI-TrainingData/BraTS-GLI-02165-101/BraTS-GLI-02165-101-t2w.nii.gz,../../DataSet/BraTS2024-BraTS-GLI-TrainingData/BraTS-GLI-02165-101/BraTS-GLI-02165-101-t2f.nii.gz,../../DataSet/BraTS2024-BraTS-GLI-TrainingData/BraTS-GLI-02165-101/BraTS-GLI-02165-101-t1n.nii.gz,../../DataSet/BraTS2024-BraTS-GLI-TrainingData/BraTS-GLI-02165-101/BraTS-GLI-02165-101-seg.nii.gz,56,114,67,32,78,83,144,50,88,46,61,38
02739-101,../../DataSet/BraTS2024-BraTS-GLI-TrainingData/BraTS-GLI-02739-101/BraTS-GLI-02739-101-t1c.nii.gz,../../DataSet/BraTS2024-BraTS-GLI-TrainingData/BraTS-GLI-02739-101/BraTS-GLI-02739-101-t2w.nii.gz,../../DataSet/BraTS2024-BraTS-GLI-TrainingData/BraTS-GLI-02739-101/BraTS-GLI-02739-101-t2f.nii.gz,../../DataSet/BraTS2024-BraTS-GLI-TrainingData/BraTS-GLI-02739-101/BraTS-GLI-02739-101-t1n.nii.gz,../../DataSet/BraTS2024-BraTS-GLI-TrainingData/BraTS-GLI-02739-101/BraTS-GLI-02739-101-seg.nii.gz,74,167,79,57,91,142,190,51,112,34,48,61
02358-101,../../DataSet/BraTS2024-BraTS-GLI-TrainingData/BraTS-GLI-02358-101/BraTS-GLI-02358-101-t1c.nii.gz,../../DataSet/BraTS2024-BraTS-GLI-TrainingData/BraTS-GLI-02358-101/BraTS-GLI-02358-101-t2w.nii.gz,../../DataSet/BraTS2024-BraTS-GLI-TrainingData/BraTS-GLI-02358-101/BraTS-GLI-02358-101-t2f.nii.gz,../../DataSet/BraTS2024-BraTS-GLI-TrainingData/BraTS-GLI-02358-101/BraTS-GLI-02358-101-t1n.nii.gz,../../DataSet/BraTS2024-BraTS-GLI-TrainingData/BraTS-GLI-02358-101/BraTS-GLI-02358-101-seg.nii.gz,108,109,111,67,153,70,145,72,140,86,75,68
02904-101,../../DataSet/BraTS2024-BraTS-GLI-TrainingData/BraTS-GLI-02904-101/BraTS-GLI-02904-101-t1c.nii.gz,../../DataSet/BraTS2024-BraTS-GLI-TrainingData/BraTS-GLI-02904-101/BraTS-GLI-02904-101-t2w.nii.gz,../../DataSet/BraTS2024-BraTS-GLI-TrainingData/BraTS-GLI-02904-101/BraTS-GLI-02904-101-t2f.nii.gz,../../DataSet/BraTS2024-BraTS-GLI-TrainingData/BraTS-GLI-02904-101/BraTS-GLI-02904-101-t1n.nii.gz,../../DataSet/BraTS2024-BraTS-GLI-TrainingData/BraTS-GLI-02904-101/BraTS-GLI-02904-101-seg.nii.gz,73,120,129,58,90,86,145,108,150,32,59,42
02886-100,../../DataSet/BraTS2024-BraTS-GLI-TrainingData/BraTS-GLI-02886-100/BraTS-GLI-02886-100-t1c.nii.gz,../../DataSet/BraTS2024-BraTS-GLI-TrainingData/BraTS-GLI-02886-100/BraTS-GLI-02886-100-t2w.nii.gz,../../DataSet/BraTS2024-BraTS-GLI-TrainingData/BraTS-GLI-02886-100/BraTS-GLI-02886-100-t2f.nii.gz,../../DataSet/BraTS2024-BraTS-GLI-TrainingData/BraTS-GLI-02886-100/BraTS-GLI-02886-100-t1n.nii.gz,../../DataSet/BraTS2024-BraTS-GLI-TrainingData/BraTS-GLI-02886-100/BraTS-GLI-02886-100-seg.nii.gz,72,125,130,54,98,95,153,103,151,44,58,48
03021-101,../../DataSet/BraTS2024-BraTS-GLI-TrainingData/BraTS-GLI-03021-101/BraTS-GLI-03021-101-t1c.nii.gz,../../DataSet/BraTS2024-BraTS-GLI-TrainingData/BraTS-GLI-03021-101/BraTS-GLI-03021-101-t2w.nii.gz,../../DataSet/BraTS2024-BraTS-GLI-TrainingData/BraTS-GLI-03021-101/BraTS-GLI-03021-101-t2f.nii.gz,../../DataSet/BraTS2024-BraTS-GLI-TrainingData/BraTS-GLI-03021-101/BraTS-GLI-03021-101-t1n.nii.gz,../../DataSet/BraTS2024-BraTS-GLI-TrainingData/BraTS-GLI-03021-101/BraTS-GLI-03021-101-seg.nii.gz,63,134,82,45,83,105,167,51,113,38,62,62
02382-100,../../DataSet/BraTS2024-BraTS-GLI-TrainingData/BraTS-GLI-02382-100/BraTS-GLI-02382-100-t1c.nii.gz,../../DataSet/BraTS2024-BraTS-GLI-TrainingData/BraTS-GLI-02382-100/BraTS-GLI-02382-100-t2w.nii.gz,../../DataSet/BraTS2024-BraTS-GLI-TrainingData/BraTS-GLI-02382-100/BraTS-GLI-02382-100-t2f.nii.gz,../../DataSet/BraTS2024-BraTS-GLI-TrainingData/BraTS-GLI-02382-100/BraTS-GLI-02382-100-t1n.nii.gz,../../DataSet/BraTS2024-BraTS-GLI-TrainingData/BraTS-GLI-02382-100/BraTS-GLI-02382-100-seg.nii.gz,67,58,79,37,93,32,92,43,117,56,60,74
02238-103,../../DataSet/BraTS2024-BraTS-GLI-TrainingData/BraTS-GLI-02238-103/BraTS-GLI-02238-103-t1c.nii.gz,../../DataSet/BraTS2024-BraTS-GLI-TrainingData/BraTS-GLI-02238-103/BraTS-GLI-02238-103-t2w.nii.gz,../../DataSet/BraTS2024-BraTS-GLI-TrainingData/BraTS-GLI-02238-103/BraTS-GLI-02238-103-t2f.nii.gz,../../DataSet/BraTS2024-BraTS-GLI-TrainingData/BraTS-GLI-02238-103/BraTS-GLI-02238-103-t1n.nii.gz,../../DataSet/BraTS2024-BraTS-GLI-TrainingData/BraTS-GLI-02238-103/BraTS-GLI-02238-103-seg.nii.gz,74,160,102,54,93,127,198,70,138,39,71,68
02160-100,../../DataSet/BraTS2024-BraTS-GLI-TrainingData/BraTS-GLI-02160-100/BraTS-GLI-02160-100-t1c.nii.gz,../../DataSet/BraTS2024-BraTS-GLI-TrainingData/BraTS-GLI-02160-100/BraTS-GLI-02160-100-t2w.nii.gz,../../DataSet/BraTS2024-BraTS-GLI-TrainingData/BraTS-GLI-02160-100/BraTS-GLI-02160-100-t2f.nii.gz,../../DataSet/BraTS2024-BraTS-GLI-TrainingData/BraTS-GLI-02160-100/BraTS-GLI-02160-100-t1n.nii.gz,../../DataSet/BraTS2024-BraTS-GLI-TrainingData/BraTS-GLI-02160-100/BraTS-GLI-02160-100-seg.nii.gz,112,53,86,59,142,20,109,54,125,83,89,71
02745-101,../../DataSet/BraTS2024-BraTS-GLI-TrainingData/BraTS-GLI-02745-101/BraTS-GLI-02745-101-t1c.nii.gz,../../DataSet/BraTS2024-BraTS-GLI-TrainingData/BraTS-GLI-02745-101/BraTS-GLI-02745-101-t2w.nii.gz,../../DataSet/BraTS2024-BraTS-GLI-TrainingData/BraTS-GLI-02745-101/BraTS-GLI-02745-101-t2f.nii.gz,../../DataSet/BraTS2024-BraTS-GLI-TrainingData/BraTS-GLI-02745-101/BraTS-GLI-02745-101-t1n.nii.gz,../../DataSet/BraTS2024-BraTS-GLI-TrainingData/BraTS-GLI-02745-101/BraTS-GLI-02745-101-seg.nii.gz,62,70,49,41,93,47,104,29,68,52,57,39
02973-100,../../DataSet/BraTS2024-BraTS-GLI-TrainingData/BraTS-GLI-02973-100/BraTS-GLI-02973-100-t1c.nii.gz,../../DataSet/BraTS2024-BraTS-GLI-TrainingData/BraTS-GLI-02973-100/BraTS-GLI-02973-100-t2w.nii.gz,../../DataSet/BraTS2024-BraTS-GLI-TrainingData/BraTS-GLI-02973-100/BraTS-GLI-02973-100-t2f.nii.gz,../../DataSet/BraTS2024-BraTS-GLI-TrainingData/BraTS-GLI-02973-100/BraTS-GLI-02973-100-t1n.nii.gz,../../DataSet/BraTS2024-BraTS-GLI-TrainingData/BraTS-GLI-02973-100/BraTS-GLI-02973-100-seg.nii.gz,119,86,92,65,152,52,123,51,130,87,71,79
02193-104,../../DataSet/BraTS2024-BraTS-GLI-TrainingData/BraTS-GLI-02193-104/BraTS-GLI-02193-104-t1c.nii.gz,../../DataSet/BraTS2024-BraTS-GLI-TrainingData/BraTS-GLI-02193-104/BraTS-GLI-02193-104-t2w.nii.gz,../../DataSet/BraTS2024-BraTS-GLI-TrainingData/BraTS-GLI-02193-104/BraTS-GLI-02193-104-t2f.nii.gz,../../DataSet/BraTS2024-BraTS-GLI-TrainingData/BraTS-GLI-02193-104/BraTS-GLI-02193-104-t1n.nii.gz,../../DataSet/BraTS2024-BraTS-GLI-TrainingData/BraTS-GLI-02193-104/BraTS-GLI-02193-104-seg.nii.gz,128,79,110,97,156,43,126,70,142,59,83,72
02820-101,../../DataSet/BraTS2024-BraTS-GLI-TrainingData/BraTS-GLI-02820-101/BraTS-GLI-02820-101-t1c.nii.gz,../../DataSet/BraTS2024-BraTS-GLI-TrainingData/BraTS-GLI-02820-101/BraTS-GLI-02820-101-t2w.nii.gz,../../DataSet/BraTS2024-BraTS-GLI-TrainingData/BraTS-GLI-02820-101/BraTS-GLI-02820-101-t2f.nii.gz,../../DataSet/BraTS2024-BraTS-GLI-TrainingData/BraTS-GLI-02820-101/BraTS-GLI-02820-101-t1n.nii.gz,../../DataSet/BraTS2024-BraTS-GLI-TrainingData/BraTS-GLI-02820-101/BraTS-GLI-02820-101-seg.nii.gz,78,131,120,46,118,85,174,92,151,72,89,59
02794-101,../../DataSet/BraTS2024-BraTS-GLI-TrainingData/BraTS-GLI-02794-101/BraTS-GLI-02794-101-t1c.nii.gz,../../DataSet/BraTS2024-BraTS-GLI-TrainingData/BraTS-GLI-02794-101/BraTS-GLI-02794-101-t2w.nii.gz,../../DataSet/BraTS2024-BraTS-GLI-TrainingData/BraTS-GLI-02794-101/BraTS-GLI-02794-101-t2f.nii.gz,../../DataSet/BraTS2024-BraTS-GLI-TrainingData/BraTS-GLI-02794-101/BraTS-GLI-02794-101-t1n.nii.gz,../../DataSet/BraTS2024-BraTS-GLI-TrainingData/BraTS-GLI-02794-101/BraTS-GLI-02794-101-seg.nii.gz,125,126,109,100,153,95,156,85,127,53,61,42
00529-101,../../DataSet/BraTS2024-BraTS-GLI-TrainingData/BraTS-GLI-00529-101/BraTS-GLI-00529-101-t1c.nii.gz,../../DataSet/BraTS2024-BraTS-GLI-TrainingData/BraTS-GLI-00529-101/BraTS-GLI-00529-101-t2w.nii.gz,../../DataSet/BraTS2024-BraTS-GLI-TrainingData/BraTS-GLI-00529-101/BraTS-GLI-00529-101-t2f.nii.gz,../../DataSet/BraTS2024-BraTS-GLI-TrainingData/BraTS-GLI-00529-101/BraTS-GLI-00529-101-t1n.nii.gz,../../DataSet/BraTS2024-BraTS-GLI-TrainingData/BraTS-GLI-00529-101/BraTS-GLI-00529-101-seg.nii.gz,123,118,104,103,148,69,165,73,135,45,96,62
02244-103,../../DataSet/BraTS2024-BraTS-GLI-TrainingData/BraTS-GLI-02244-103/BraTS-GLI-02244-103-t1c.nii.gz,../../DataSet/BraTS2024-BraTS-GLI-TrainingData/BraTS-GLI-02244-103/BraTS-GLI-02244-103-t2w.nii.gz,../../DataSet/BraTS2024-BraTS-GLI-TrainingData/BraTS-GLI-02244-103/BraTS-GLI-02244-103-t2f.nii.gz,../../DataSet/BraTS2024-BraTS-GLI-TrainingData/BraTS-GLI-02244-103/BraTS-GLI-02244-103-t1n.nii.gz,../../DataSet/BraTS2024-BraTS-GLI-TrainingData/BraTS-GLI-02244-103/BraTS-GLI-02244-103-seg.nii.gz,77,146,107,53,97,114,181,64,147,44,67,83
02167-100,../../DataSet/BraTS2024-BraTS-GLI-TrainingData/BraTS-GLI-02167-100/BraTS-GLI-02167-100-t1c.nii.gz,../../DataSet/BraTS2024-BraTS-GLI-TrainingData/BraTS-GLI-02167-100/BraTS-GLI-02167-100-t2w.nii.gz,../../DataSet/BraTS2024-BraTS-GLI-TrainingData/BraTS-GLI-02167-100/BraTS-GLI-02167-100-t2f.nii.gz,../../DataSet/BraTS2024-BraTS-GLI-TrainingData/BraTS-GLI-02167-100/BraTS-GLI-02167-100-t1n.nii.gz,../../DataSet/BraTS2024-BraTS-GLI-TrainingData/BraTS-GLI-02167-100/BraTS-GLI-02167-100-seg.nii.gz,44,122,70,26,72,97,142,49,91,46,45,42
02827-101,../../DataSet/BraTS2024-BraTS-GLI-TrainingData/BraTS-GLI-02827-101/BraTS-GLI-02827-101-t1c.nii.gz,../../DataSet/BraTS2024-BraTS-GLI-TrainingData/BraTS-GLI-02827-101/BraTS-GLI-02827-101-t2w.nii.gz,../../DataSet/BraTS2024-BraTS-GLI-TrainingData/BraTS-GLI-02827-101/BraTS-GLI-02827-101-t2f.nii.gz,../../DataSet/BraTS2024-BraTS-GLI-TrainingData/BraTS-GLI-02827-101/BraTS-GLI-02827-101-t1n.nii.gz,../../DataSet/BraTS2024-BraTS-GLI-TrainingData/BraTS-GLI-02827-101/BraTS-GLI-02827-101-seg.nii.gz,129,119,67,104,155,84,149,45,107,51,65,62
02248-102,../../DataSet/BraTS2024-BraTS-GLI-TrainingData/BraTS-GLI-02248-102/BraTS-GLI-02248-102-t1c.nii.gz,../../DataSet/BraTS2024-BraTS-GLI-TrainingData/BraTS-GLI-02248-102/BraTS-GLI-02248-102-t2w.nii.gz,../../DataSet/BraTS2024-BraTS-GLI-TrainingData/BraTS-GLI-02248-102/BraTS-GLI-02248-102-t2f.nii.gz,../../DataSet/BraTS2024-BraTS-GLI-TrainingData/BraTS-GLI-02248-102/BraTS-GLI-02248-102-t1n.nii.gz,../../DataSet/BraTS2024-BraTS-GLI-TrainingData/BraTS-GLI-02248-102/BraTS-GLI-02248-102-seg.nii.gz,104,82,105,64,125,54,126,75,144,61,72,69
02524-104,../../DataSet/BraTS2024-BraTS-GLI-TrainingData/BraTS-GLI-02524-104/BraTS-GLI-02524-104-t1c.nii.gz,../../DataSet/BraTS2024-BraTS-GLI-TrainingData/BraTS-GLI-02524-104/BraTS-GLI-02524-104-t2w.nii.gz,../../DataSet/BraTS2024-BraTS-GLI-TrainingData/BraTS-GLI-02524-104/BraTS-GLI-02524-104-t2f.nii.gz,../../DataSet/BraTS2024-BraTS-GLI-TrainingData/BraTS-GLI-02524-104/BraTS-GLI-02524-104-t1n.nii.gz,../../DataSet/BraTS2024-BraTS-GLI-TrainingData/BraTS-GLI-02524-104/BraTS-GLI-02524-104-seg.nii.gz,110,110,115,71,141,72,147,85,150,70,75,65
03051-100,../../DataSet/BraTS2024-BraTS-GLI-TrainingData/BraTS-GLI-03051-100/BraTS-GLI-03051-100-t1c.nii.gz,../../DataSet/BraTS2024-BraTS-GLI-TrainingData/BraTS-GLI-03051-100/BraTS-GLI-03051-100-t2w.nii.gz,../../DataSet/BraTS2024-BraTS-GLI-TrainingData/BraTS-GLI-03051-100/BraTS-GLI-03051-100-t2f.nii.gz,../../DataSet/BraTS2024-BraTS-GLI-TrainingData/BraTS-GLI-03051-100/BraTS-GLI-03051-100-t1n.nii.gz,../../DataSet/BraTS2024-BraTS-GLI-TrainingData/BraTS-GLI-03051-100/BraTS-GLI-03051-100-seg.nii.gz,76,86,112,55,103,46,126,84,145,48,80,61
02798-100,../../DataSet/BraTS2024-BraTS-GLI-TrainingData/BraTS-GLI-02798-100/BraTS-GLI-02798-100-t1c.nii.gz,../../DataSet/BraTS2024-BraTS-GLI-TrainingData/BraTS-GLI-02798-100/BraTS-GLI-02798-100-t2w.nii.gz,../../DataSet/BraTS2024-BraTS-GLI-TrainingData/BraTS-GLI-02798-100/BraTS-GLI-02798-100-t2f.nii.gz,../../DataSet/BraTS2024-BraTS-GLI-TrainingData/BraTS-GLI-02798-100/BraTS-GLI-02798-100-t1n.nii.gz,../../DataSet/BraTS2024-BraTS-GLI-TrainingData/BraTS-GLI-02798-100/BraTS-GLI-02798-100-seg.nii.gz,132,79,109,115,147,71,90,105,120,32,19,15
02881-100,../../DataSet/BraTS2024-BraTS-GLI-TrainingData/BraTS-GLI-02881-100/BraTS-GLI-02881-100-t1c.nii.gz,../../DataSet/BraTS2024-BraTS-GLI-TrainingData/BraTS-GLI-02881-100/BraTS-GLI-02881-100-t2w.nii.gz,../../DataSet/BraTS2024-BraTS-GLI-TrainingData/BraTS-GLI-02881-100/BraTS-GLI-02881-100-t2f.nii.gz,../../DataSet/BraTS2024-BraTS-GLI-TrainingData/BraTS-GLI-02881-100/BraTS-GLI-02881-100-t1n.nii.gz,../../DataSet/BraTS2024-BraTS-GLI-TrainingData/BraTS-GLI-02881-100/BraTS-GLI-02881-100-seg.nii.gz,92,104,99,52,134,69,149,47,129,82,80,82
02903-101,../../DataSet/BraTS2024-BraTS-GLI-TrainingData/BraTS-GLI-02903-101/BraTS-GLI-02903-101-t1c.nii.gz,../../DataSet/BraTS2024-BraTS-GLI-TrainingData/BraTS-GLI-02903-101/BraTS-GLI-02903-101-t2w.nii.gz,../../DataSet/BraTS2024-BraTS-GLI-TrainingData/BraTS-GLI-02903-101/BraTS-GLI-02903-101-t2f.nii.gz,../../DataSet/BraTS2024-BraTS-GLI-TrainingData/BraTS-GLI-02903-101/BraTS-GLI-02903-101-t1n.nii.gz,../../DataSet/BraTS2024-BraTS-GLI-TrainingData/BraTS-GLI-02903-101/BraTS-GLI-02903-101-seg.nii.gz,48,75,79,27,78,38,115,59,114,51,77,55
02354-100,../../DataSet/BraTS2024-BraTS-GLI-TrainingData/BraTS-GLI-02354-100/BraTS-GLI-02354-100-t1c.nii.gz,../../DataSet/BraTS2024-BraTS-GLI-TrainingData/BraTS-GLI-02354-100/BraTS-GLI-02354-100-t2w.nii.gz,../../DataSet/BraTS2024-BraTS-GLI-TrainingData/BraTS-GLI-02354-100/BraTS-GLI-02354-100-t2f.nii.gz,../../DataSet/BraTS2024-BraTS-GLI-TrainingData/BraTS-GLI-02354-100/BraTS-GLI-02354-100-t1n.nii.gz,../../DataSet/BraTS2024-BraTS-GLI-TrainingData/BraTS-GLI-02354-100/BraTS-GLI-02354-100-seg.nii.gz,60,64,106,27,90,36,98,75,142,63,62,67
02128-103,../../DataSet/BraTS2024-BraTS-GLI-TrainingData/BraTS-GLI-02128-103/BraTS-GLI-02128-103-t1c.nii.gz,../../DataSet/BraTS2024-BraTS-GLI-TrainingData/BraTS-GLI-02128-103/BraTS-GLI-02128-103-t2w.nii.gz,../../DataSet/BraTS2024-BraTS-GLI-TrainingData/BraTS-GLI-02128-103/BraTS-GLI-02128-103-t2f.nii.gz,../../DataSet/BraTS2024-BraTS-GLI-TrainingData/BraTS-GLI-02128-103/BraTS-GLI-02128-103-t1n.nii.gz,../../DataSet/BraTS2024-BraTS-GLI-TrainingData/BraTS-GLI-02128-103/BraTS-GLI-02128-103-seg.nii.gz,77,82,120,45,132,46,125,83,155,87,79,72
02092-100,../../DataSet/BraTS2024-BraTS-GLI-TrainingData/BraTS-GLI-02092-100/BraTS-GLI-02092-100-t1c.nii.gz,../../DataSet/BraTS2024-BraTS-GLI-TrainingData/BraTS-GLI-02092-100/BraTS-GLI-02092-100-t2w.nii.gz,../../DataSet/BraTS2024-BraTS-GLI-TrainingData/BraTS-GLI-02092-100/BraTS-GLI-02092-100-t2f.nii.gz,../../DataSet/BraTS2024-BraTS-GLI-TrainingData/BraTS-GLI-02092-100/BraTS-GLI-02092-100-t1n.nii.gz,../../DataSet/BraTS2024-BraTS-GLI-TrainingData/BraTS-GLI-02092-100/BraTS-GLI-02092-100-seg.nii.gz,102,163,91,66,134,127,196,55,130,68,69,75
02735-100,../../DataSet/BraTS2024-BraTS-GLI-TrainingData/BraTS-GLI-02735-100/BraTS-GLI-02735-100-t1c.nii.gz,../../DataSet/BraTS2024-BraTS-GLI-TrainingData/BraTS-GLI-02735-100/BraTS-GLI-02735-100-t2w.nii.gz,../../DataSet/BraTS2024-BraTS-GLI-TrainingData/BraTS-GLI-02735-100/BraTS-GLI-02735-100-t2f.nii.gz,../../DataSet/BraTS2024-BraTS-GLI-TrainingData/BraTS-GLI-02735-100/BraTS-GLI-02735-100-t1n.nii.gz,../../DataSet/BraTS2024-BraTS-GLI-TrainingData/BraTS-GLI-02735-100/BraTS-GLI-02735-100-seg.nii.gz,63,157,93,42,81,121,192,64,127,39,71,63
02207-101,../../DataSet/BraTS2024-BraTS-GLI-TrainingData/BraTS-GLI-02207-101/BraTS-GLI-02207-101-t1c.nii.gz,../../DataSet/BraTS2024-BraTS-GLI-TrainingData/BraTS-GLI-02207-101/BraTS-GLI-02207-101-t2w.nii.gz,../../DataSet/BraTS2024-BraTS-GLI-TrainingData/BraTS-GLI-02207-101/BraTS-GLI-02207-101-t2f.nii.gz,../../DataSet/BraTS2024-BraTS-GLI-TrainingData/BraTS-GLI-02207-101/BraTS-GLI-02207-101-t1n.nii.gz,../../DataSet/BraTS2024-BraTS-GLI-TrainingData/BraTS-GLI-02207-101/BraTS-GLI-02207-101-seg.nii.gz,115,161,75,69,149,123,198,51,105,80,75,54
03064-100,../../DataSet/BraTS2024-BraTS-GLI-TrainingData/BraTS-GLI-03064-100/BraTS-GLI-03064-100-t1c.nii.gz,../../DataSet/BraTS2024-BraTS-GLI-TrainingData/BraTS-GLI-03064-100/BraTS-GLI-03064-100-t2w.nii.gz,../../DataSet/BraTS2024-BraTS-GLI-TrainingData/BraTS-GLI-03064-100/BraTS-GLI-03064-100-t2f.nii.gz,../../DataSet/BraTS2024-BraTS-GLI-TrainingData/BraTS-GLI-03064-100/BraTS-GLI-03064-100-t1n.nii.gz,../../DataSet/BraTS2024-BraTS-GLI-TrainingData/BraTS-GLI-03064-100/BraTS-GLI-03064-100-seg.nii.gz,122,64,94,75,155,25,116,60,137,80,91,77
02245-100,../../DataSet/BraTS2024-BraTS-GLI-TrainingData/BraTS-GLI-02245-100/BraTS-GLI-02245-100-t1c.nii.gz,../../DataSet/BraTS2024-BraTS-GLI-TrainingData/BraTS-GLI-02245-100/BraTS-GLI-02245-100-t2w.nii.gz,../../DataSet/BraTS2024-BraTS-GLI-TrainingData/BraTS-GLI-02245-100/BraTS-GLI-02245-100-t2f.nii.gz,../../DataSet/BraTS2024-BraTS-GLI-TrainingData/BraTS-GLI-02245-100/BraTS-GLI-02245-100-t1n.nii.gz,../../DataSet/BraTS2024-BraTS-GLI-TrainingData/BraTS-GLI-02245-100/BraTS-GLI-02245-100-seg.nii.gz,78,134,125,64,88,110,158,108,146,24,48,38
02941-100,../../DataSet/BraTS2024-BraTS-GLI-TrainingData/BraTS-GLI-02941-100/BraTS-GLI-02941-100-t1c.nii.gz,../../DataSet/BraTS2024-BraTS-GLI-TrainingData/BraTS-GLI-02941-100/BraTS-GLI-02941-100-t2w.nii.gz,../../DataSet/BraTS2024-BraTS-GLI-TrainingData/BraTS-GLI-02941-100/BraTS-GLI-02941-100-t2f.nii.gz,../../DataSet/BraTS2024-BraTS-GLI-TrainingData/BraTS-GLI-02941-100/BraTS-GLI-02941-100-t1n.nii.gz,../../DataSet/BraTS2024-BraTS-GLI-TrainingData/BraTS-GLI-02941-100/BraTS-GLI-02941-100-seg.nii.gz,104,86,137,91,121,60,112,113,158,30,52,45
02188-101,../../DataSet/BraTS2024-BraTS-GLI-TrainingData/BraTS-GLI-02188-101/BraTS-GLI-02188-101-t1c.nii.gz,../../DataSet/BraTS2024-BraTS-GLI-TrainingData/BraTS-GLI-02188-101/BraTS-GLI-02188-101-t2w.nii.gz,../../DataSet/BraTS2024-BraTS-GLI-TrainingData/BraTS-GLI-02188-101/BraTS-GLI-02188-101-t2f.nii.gz,../../DataSet/BraTS2024-BraTS-GLI-TrainingData/BraTS-GLI-02188-101/BraTS-GLI-02188-101-t1n.nii.gz,../../DataSet/BraTS2024-BraTS-GLI-TrainingData/BraTS-GLI-02188-101/BraTS-GLI-02188-101-seg.nii.gz,65,111,130,45,84,95,128,109,154,39,33,45
02658-100,../../DataSet/BraTS2024-BraTS-GLI-TrainingData/BraTS-GLI-02658-100/BraTS-GLI-02658-100-t1c.nii.gz,../../DataSet/BraTS2024-BraTS-GLI-TrainingData/BraTS-GLI-02658-100/BraTS-GLI-02658-100-t2w.nii.gz,../../DataSet/BraTS2024-BraTS-GLI-TrainingData/BraTS-GLI-02658-100/BraTS-GLI-02658-100-t2f.nii.gz,../../DataSet/BraTS2024-BraTS-GLI-TrainingData/BraTS-GLI-02658-100/BraTS-GLI-02658-100-t1n.nii.gz,../../DataSet/BraTS2024-BraTS-GLI-TrainingData/BraTS-GLI-02658-100/BraTS-GLI-02658-100-seg.nii.gz,53,126,73,32,94,81,157,38,116,62,76,78
03018-100,../../DataSet/BraTS2024-BraTS-GLI-TrainingData/BraTS-GLI-03018-100/BraTS-GLI-03018-100-t1c.nii.gz,../../DataSet/BraTS2024-BraTS-GLI-TrainingData/BraTS-GLI-03018-100/BraTS-GLI-03018-100-t2w.nii.gz,../../DataSet/BraTS2024-BraTS-GLI-TrainingData/BraTS-GLI-03018-100/BraTS-GLI-03018-100-t2f.nii.gz,../../DataSet/BraTS2024-BraTS-GLI-TrainingData/BraTS-GLI-03018-100/BraTS-GLI-03018-100-t1n.nii.gz,../../DataSet/BraTS2024-BraTS-GLI-TrainingData/BraTS-GLI-03018-100/BraTS-GLI-03018-100-seg.nii.gz,127,79,103,105,150,57,116,73,123,45,59,50
02239-100,../../DataSet/BraTS2024-BraTS-GLI-TrainingData/BraTS-GLI-02239-100/BraTS-GLI-02239-100-t1c.nii.gz,../../DataSet/BraTS2024-BraTS-GLI-TrainingData/BraTS-GLI-02239-100/BraTS-GLI-02239-100-t2w.nii.gz,../../DataSet/BraTS2024-BraTS-GLI-TrainingData/BraTS-GLI-02239-100/BraTS-GLI-02239-100-t2f.nii.gz,../../DataSet/BraTS2024-BraTS-GLI-TrainingData/BraTS-GLI-02239-100/BraTS-GLI-02239-100-t1n.nii.gz,../../DataSet/BraTS2024-BraTS-GLI-TrainingData/BraTS-GLI-02239-100/BraTS-GLI-02239-100-seg.nii.gz,53,132,48,32,74,109,156,30,72,42,47,42
02689-100,../../DataSet/BraTS2024-BraTS-GLI-TrainingData/BraTS-GLI-02689-100/BraTS-GLI-02689-100-t1c.nii.gz,../../DataSet/BraTS2024-BraTS-GLI-TrainingData/BraTS-GLI-02689-100/BraTS-GLI-02689-100-t2w.nii.gz,../../DataSet/BraTS2024-BraTS-GLI-TrainingData/BraTS-GLI-02689-100/BraTS-GLI-02689-100-t2f.nii.gz,../../DataSet/BraTS2024-BraTS-GLI-TrainingData/BraTS-GLI-02689-100/BraTS-GLI-02689-100-t1n.nii.gz,../../DataSet/BraTS2024-BraTS-GLI-TrainingData/BraTS-GLI-02689-100/BraTS-GLI-02689-100-seg.nii.gz,120,77,91,92,149,37,122,41,133,57,85,92
02865-100,../../DataSet/BraTS2024-BraTS-GLI-TrainingData/BraTS-GLI-02865-100/BraTS-GLI-02865-100-t1c.nii.gz,../../DataSet/BraTS2024-BraTS-GLI-TrainingData/BraTS-GLI-02865-100/BraTS-GLI-02865-100-t2w.nii.gz,../../DataSet/BraTS2024-BraTS-GLI-TrainingData/BraTS-GLI-02865-100/BraTS-GLI-02865-100-t2f.nii.gz,../../DataSet/BraTS2024-BraTS-GLI-TrainingData/BraTS-GLI-02865-100/BraTS-GLI-02865-100-t1n.nii.gz,../../DataSet/BraTS2024-BraTS-GLI-TrainingData/BraTS-GLI-02865-100/BraTS-GLI-02865-100-seg.nii.gz,68,94,117,48,92,61,132,93,150,44,71,57
02599-100,../../DataSet/BraTS2024-BraTS-GLI-TrainingData/BraTS-GLI-02599-100/BraTS-GLI-02599-100-t1c.nii.gz,../../DataSet/BraTS2024-BraTS-GLI-TrainingData/BraTS-GLI-02599-100/BraTS-GLI-02599-100-t2w.nii.gz,../../DataSet/BraTS2024-BraTS-GLI-TrainingData/BraTS-GLI-02599-100/BraTS-GLI-02599-100-t2f.nii.gz,../../DataSet/BraTS2024-BraTS-GLI-TrainingData/BraTS-GLI-02599-100/BraTS-GLI-02599-100-t1n.nii.gz,../../DataSet/BraTS2024-BraTS-GLI-TrainingData/BraTS-GLI-02599-100/BraTS-GLI-02599-100-seg.nii.gz,81,81,44,44,127,50,118,15,89,83,68,74
02548-100,../../DataSet/BraTS2024-BraTS-GLI-TrainingData/BraTS-GLI-02548-100/BraTS-GLI-02548-100-t1c.nii.gz,../../DataSet/BraTS2024-BraTS-GLI-TrainingData/BraTS-GLI-02548-100/BraTS-GLI-02548-100-t2w.nii.gz,../../DataSet/BraTS2024-BraTS-GLI-TrainingData/BraTS-GLI-02548-100/BraTS-GLI-02548-100-t2f.nii.gz,../../DataSet/BraTS2024-BraTS-GLI-TrainingData/BraTS-GLI-02548-100/BraTS-GLI-02548-100-t1n.nii.gz,../../DataSet/BraTS2024-BraTS-GLI-TrainingData/BraTS-GLI-02548-100/BraTS-GLI-02548-100-seg.nii.gz,126,91,64,104,149,65,129,43,87,45,64,44
02093-103,../../DataSet/BraTS2024-BraTS-GLI-TrainingData/BraTS-GLI-02093-103/BraTS-GLI-02093-103-t1c.nii.gz,../../DataSet/BraTS2024-BraTS-GLI-TrainingData/BraTS-GLI-02093-103/BraTS-GLI-02093-103-t2w.nii.gz,../../DataSet/BraTS2024-BraTS-GLI-TrainingData/BraTS-GLI-02093-103/BraTS-GLI-02093-103-t2f.nii.gz,../../DataSet/BraTS2024-BraTS-GLI-TrainingData/BraTS-GLI-02093-103/BraTS-GLI-02093-103-t1n.nii.gz,../../DataSet/BraTS2024-BraTS-GLI-TrainingData/BraTS-GLI-02093-103/BraTS-GLI-02093-103-seg.nii.gz,108,169,97,68,139,119,199,54,142,71,80,88
02111-102,../../DataSet/BraTS2024-BraTS-GLI-TrainingData/BraTS-GLI-02111-102/BraTS-GLI-02111-102-t1c.nii.gz,../../DataSet/BraTS2024-BraTS-GLI-TrainingData/BraTS-GLI-02111-102/BraTS-GLI-02111-102-t2w.nii.gz,../../DataSet/BraTS2024-BraTS-GLI-TrainingData/BraTS-GLI-02111-102/BraTS-GLI-02111-102-t2f.nii.gz,../../DataSet/BraTS2024-BraTS-GLI-TrainingData/BraTS-GLI-02111-102/BraTS-GLI-02111-102-t1n.nii.gz,../../DataSet/BraTS2024-BraTS-GLI-TrainingData/BraTS-GLI-02111-102/BraTS-GLI-02111-102-seg.nii.gz,74,76,116,52,119,52,114,80,152,67,62,72
02862-100,../../DataSet/BraTS2024-BraTS-GLI-TrainingData/BraTS-GLI-02862-100/BraTS-GLI-02862-100-t1c.nii.gz,../../DataSet/BraTS2024-BraTS-GLI-TrainingData/BraTS-GLI-02862-100/BraTS-GLI-02862-100-t2w.nii.gz,../../DataSet/BraTS2024-BraTS-GLI-TrainingData/BraTS-GLI-02862-100/BraTS-GLI-02862-100-t2f.nii.gz,../../DataSet/BraTS2024-BraTS-GLI-TrainingData/BraTS-GLI-02862-100/BraTS-GLI-02862-100-t1n.nii.gz,../../DataSet/BraTS2024-BraTS-GLI-TrainingData/BraTS-GLI-02862-100/BraTS-GLI-02862-100-seg.nii.gz,128,136,62,90,145,81,155,50,90,55,74,40
02071-100,../../DataSet/BraTS2024-BraTS-GLI-TrainingData/BraTS-GLI-02071-100/BraTS-GLI-02071-100-t1c.nii.gz,../../DataSet/BraTS2024-BraTS-GLI-TrainingData/BraTS-GLI-02071-100/BraTS-GLI-02071-100-t2w.nii.gz,../../DataSet/BraTS2024-BraTS-GLI-TrainingData/BraTS-GLI-02071-100/BraTS-GLI-02071-100-t2f.nii.gz,../../DataSet/BraTS2024-BraTS-GLI-TrainingData/BraTS-GLI-02071-100/BraTS-GLI-02071-100-t1n.nii.gz,../../DataSet/BraTS2024-BraTS-GLI-TrainingData/BraTS-GLI-02071-100/BraTS-GLI-02071-100-seg.nii.gz,51,100,86,25,77,62,153,44,129,52,91,85
03063-100,../../DataSet/BraTS2024-BraTS-GLI-TrainingData/BraTS-GLI-03063-100/BraTS-GLI-03063-100-t1c.nii.gz,../../DataSet/BraTS2024-BraTS-GLI-TrainingData/BraTS-GLI-03063-100/BraTS-GLI-03063-100-t2w.nii.gz,../../DataSet/BraTS2024-BraTS-GLI-TrainingData/BraTS-GLI-03063-100/BraTS-GLI-03063-100-t2f.nii.gz,../../DataSet/BraTS2024-BraTS-GLI-TrainingData/BraTS-GLI-03063-100/BraTS-GLI-03063-100-t1n.nii.gz,../../DataSet/BraTS2024-BraTS-GLI-TrainingData/BraTS-GLI-03063-100/BraTS-GLI-03063-100-seg.nii.gz,66,61,100,31,102,27,95,72,136,71,68,64
02623-100,../../DataSet/BraTS2024-BraTS-GLI-TrainingData/BraTS-GLI-02623-100/BraTS-GLI-02623-100-t1c.nii.gz,../../DataSet/BraTS2024-BraTS-GLI-TrainingData/BraTS-GLI-02623-100/BraTS-GLI-02623-100-t2w.nii.gz,../../DataSet/BraTS2024-BraTS-GLI-TrainingData/BraTS-GLI-02623-100/BraTS-GLI-02623-100-t2f.nii.gz,../../DataSet/BraTS2024-BraTS-GLI-TrainingData/BraTS-GLI-02623-100/BraTS-GLI-02623-100-t1n.nii.gz,../../DataSet/BraTS2024-BraTS-GLI-TrainingData/BraTS-GLI-02623-100/BraTS-GLI-02623-100-seg.nii.gz,85,76,100,75,93,46,110,81,122,18,64,41
02242-100,../../DataSet/BraTS2024-BraTS-GLI-TrainingData/BraTS-GLI-02242-100/BraTS-GLI-02242-100-t1c.nii.gz,../../DataSet/BraTS2024-BraTS-GLI-TrainingData/BraTS-GLI-02242-100/BraTS-GLI-02242-100-t2w.nii.gz,../../DataSet/BraTS2024-BraTS-GLI-TrainingData/BraTS-GLI-02242-100/BraTS-GLI-02242-100-t2f.nii.gz,../../DataSet/BraTS2024-BraTS-GLI-TrainingData/BraTS-GLI-02242-100/BraTS-GLI-02242-100-t1n.nii.gz,../../DataSet/BraTS2024-BraTS-GLI-TrainingData/BraTS-GLI-02242-100/BraTS-GLI-02242-100-seg.nii.gz,113,104,66,89,144,60,144,42,101,55,84,59
02946-100,../../DataSet/BraTS2024-BraTS-GLI-TrainingData/BraTS-GLI-02946-100/BraTS-GLI-02946-100-t1c.nii.gz,../../DataSet/BraTS2024-BraTS-GLI-TrainingData/BraTS-GLI-02946-100/BraTS-GLI-02946-100-t2w.nii.gz,../../DataSet/BraTS2024-BraTS-GLI-TrainingData/BraTS-GLI-02946-100/BraTS-GLI-02946-100-t2f.nii.gz,../../DataSet/BraTS2024-BraTS-GLI-TrainingData/BraTS-GLI-02946-100/BraTS-GLI-02946-100-t1n.nii.gz,../../DataSet/BraTS2024-BraTS-GLI-TrainingData/BraTS-GLI-02946-100/BraTS-GLI-02946-100-seg.nii.gz,73,95,125,57,90,72,116,114,151,33,44,37
02770-101,../../DataSet/BraTS2024-BraTS-GLI-TrainingData/BraTS-GLI-02770-101/BraTS-GLI-02770-101-t1c.nii.gz,../../DataSet/BraTS2024-BraTS-GLI-TrainingData/BraTS-GLI-02770-101/BraTS-GLI-02770-101-t2w.nii.gz,../../DataSet/BraTS2024-BraTS-GLI-TrainingData/BraTS-GLI-02770-101/BraTS-GLI-02770-101-t2f.nii.gz,../../DataSet/BraTS2024-BraTS-GLI-TrainingData/BraTS-GLI-02770-101/BraTS-GLI-02770-101-t1n.nii.gz,../../DataSet/BraTS2024-BraTS-GLI-TrainingData/BraTS-GLI-02770-101/BraTS-GLI-02770-101-seg.nii.gz,94,91,120,44,139,48,133,92,152,95,85,60
02155-100,../../DataSet/BraTS2024-BraTS-GLI-TrainingData/BraTS-GLI-02155-100/BraTS-GLI-02155-100-t1c.nii.gz,../../DataSet/BraTS2024-BraTS-GLI-TrainingData/BraTS-GLI-02155-100/BraTS-GLI-02155-100-t2w.nii.gz,../../DataSet/BraTS2024-BraTS-GLI-TrainingData/BraTS-GLI-02155-100/BraTS-GLI-02155-100-t2f.nii.gz,../../DataSet/BraTS2024-BraTS-GLI-TrainingData/BraTS-GLI-02155-100/BraTS-GLI-02155-100-t1n.nii.gz,../../DataSet/BraTS2024-BraTS-GLI-TrainingData/BraTS-GLI-02155-100/BraTS-GLI-02155-100-seg.nii.gz,78,127,118,55,112,97,155,81,151,57,58,70
02093-109,../../DataSet/BraTS2024-BraTS-GLI-TrainingData/BraTS-GLI-02093-109/BraTS-GLI-02093-109-t1c.nii.gz,../../DataSet/BraTS2024-BraTS-GLI-TrainingData/BraTS-GLI-02093-109/BraTS-GLI-02093-109-t2w.nii.gz,../../DataSet/BraTS2024-BraTS-GLI-TrainingData/BraTS-GLI-02093-109/BraTS-GLI-02093-109-t2f.nii.gz,../../DataSet/BraTS2024-BraTS-GLI-TrainingData/BraTS-GLI-02093-109/BraTS-GLI-02093-109-t1n.nii.gz,../../DataSet/BraTS2024-BraTS-GLI-TrainingData/BraTS-GLI-02093-109/BraTS-GLI-02093-109-seg.nii.gz,109,171,98,68,140,125,201,57,144,72,76,87
02651-100,../../DataSet/BraTS2024-BraTS-GLI-TrainingData/BraTS-GLI-02651-100/BraTS-GLI-02651-100-t1c.nii.gz,../../DataSet/BraTS2024-BraTS-GLI-TrainingData/BraTS-GLI-02651-100/BraTS-GLI-02651-100-t2w.nii.gz,../../DataSet/BraTS2024-BraTS-GLI-TrainingData/BraTS-GLI-02651-100/BraTS-GLI-02651-100-t2f.nii.gz,../../DataSet/BraTS2024-BraTS-GLI-TrainingData/BraTS-GLI-02651-100/BraTS-GLI-02651-100-t1n.nii.gz,../../DataSet/BraTS2024-BraTS-GLI-TrainingData/BraTS-GLI-02651-100/BraTS-GLI-02651-100-seg.nii.gz,119,154,98,96,148,102,193,67,132,52,91,65
02105-104,../../DataSet/BraTS2024-BraTS-GLI-TrainingData/BraTS-GLI-02105-104/BraTS-GLI-02105-104-t1c.nii.gz,../../DataSet/BraTS2024-BraTS-GLI-TrainingData/BraTS-GLI-02105-104/BraTS-GLI-02105-104-t2w.nii.gz,../../DataSet/BraTS2024-BraTS-GLI-TrainingData/BraTS-GLI-02105-104/BraTS-GLI-02105-104-t2f.nii.gz,../../DataSet/BraTS2024-BraTS-GLI-TrainingData/BraTS-GLI-02105-104/BraTS-GLI-02105-104-t1n.nii.gz,../../DataSet/BraTS2024-BraTS-GLI-TrainingData/BraTS-GLI-02105-104/BraTS-GLI-02105-104-seg.nii.gz,69,75,110,48,99,41,104,74,149,51,63,75
02208-102,../../DataSet/BraTS2024-BraTS-GLI-TrainingData/BraTS-GLI-02208-102/BraTS-GLI-02208-102-t1c.nii.gz,../../DataSet/BraTS2024-BraTS-GLI-TrainingData/BraTS-GLI-02208-102/BraTS-GLI-02208-102-t2w.nii.gz,../../DataSet/BraTS2024-BraTS-GLI-TrainingData/BraTS-GLI-02208-102/BraTS-GLI-02208-102-t2f.nii.gz,../../DataSet/BraTS2024-BraTS-GLI-TrainingData/BraTS-GLI-02208-102/BraTS-GLI-02208-102-t1n.nii.gz,../../DataSet/BraTS2024-BraTS-GLI-TrainingData/BraTS-GLI-02208-102/BraTS-GLI-02208-102-seg.nii.gz,107,53,101,95,156,37,111,82,113,61,74,31
02867-101,../../DataSet/BraTS2024-BraTS-GLI-TrainingData/BraTS-GLI-02867-101/BraTS-GLI-02867-101-t1c.nii.gz,../../DataSet/BraTS2024-BraTS-GLI-TrainingData/BraTS-GLI-02867-101/BraTS-GLI-02867-101-t2w.nii.gz,../../DataSet/BraTS2024-BraTS-GLI-TrainingData/BraTS-GLI-02867-101/BraTS-GLI-02867-101-t2f.nii.gz,../../DataSet/BraTS2024-BraTS-GLI-TrainingData/BraTS-GLI-02867-101/BraTS-GLI-02867-101-t1n.nii.gz,../../DataSet/BraTS2024-BraTS-GLI-TrainingData/BraTS-GLI-02867-101/BraTS-GLI-02867-101-seg.nii.gz,101,176,85,90,116,139,194,68,111,26,55,43
02230-100,../../DataSet/BraTS2024-BraTS-GLI-TrainingData/BraTS-GLI-02230-100/BraTS-GLI-02230-100-t1c.nii.gz,../../DataSet/BraTS2024-BraTS-GLI-TrainingData/BraTS-GLI-02230-100/BraTS-GLI-02230-100-t2w.nii.gz,../../DataSet/BraTS2024-BraTS-GLI-TrainingData/BraTS-GLI-02230-100/BraTS-GLI-02230-100-t2f.nii.gz,../../DataSet/BraTS2024-BraTS-GLI-TrainingData/BraTS-GLI-02230-100/BraTS-GLI-02230-100-t1n.nii.gz,../../DataSet/BraTS2024-BraTS-GLI-TrainingData/BraTS-GLI-02230-100/BraTS-GLI-02230-100-seg.nii.gz,104,132,122,54,147,110,160,94,152,93,50,58
02934-100,../../DataSet/BraTS2024-BraTS-GLI-TrainingData/BraTS-GLI-02934-100/BraTS-GLI-02934-100-t1c.nii.gz,../../DataSet/BraTS2024-BraTS-GLI-TrainingData/BraTS-GLI-02934-100/BraTS-GLI-02934-100-t2w.nii.gz,../../DataSet/BraTS2024-BraTS-GLI-TrainingData/BraTS-GLI-02934-100/BraTS-GLI-02934-100-t2f.nii.gz,../../DataSet/BraTS2024-BraTS-GLI-TrainingData/BraTS-GLI-02934-100/BraTS-GLI-02934-100-t1n.nii.gz,../../DataSet/BraTS2024-BraTS-GLI-TrainingData/BraTS-GLI-02934-100/BraTS-GLI-02934-100-seg.nii.gz,109,73,126,95,130,48,99,99,150,35,51,51
02709-100,../../DataSet/BraTS2024-BraTS-GLI-TrainingData/BraTS-GLI-02709-100/BraTS-GLI-02709-100-t1c.nii.gz,../../DataSet/BraTS2024-BraTS-GLI-TrainingData/BraTS-GLI-02709-100/BraTS-GLI-02709-100-t2w.nii.gz,../../DataSet/BraTS2024-BraTS-GLI-TrainingData/BraTS-GLI-02709-100/BraTS-GLI-02709-100-t2f.nii.gz,../../DataSet/BraTS2024-BraTS-GLI-TrainingData/BraTS-GLI-02709-100/BraTS-GLI-02709-100-t1n.nii.gz,../../DataSet/BraTS2024-BraTS-GLI-TrainingData/BraTS-GLI-02709-100/BraTS-GLI-02709-100-seg.nii.gz,132,101,108,102,155,72,126,89,131,53,54,42
02368-100,../../DataSet/BraTS2024-BraTS-GLI-TrainingData/BraTS-GLI-02368-100/BraTS-GLI-02368-100-t1c.nii.gz,../../DataSet/BraTS2024-BraTS-GLI-TrainingData/BraTS-GLI-02368-100/BraTS-GLI-02368-100-t2w.nii.gz,../../DataSet/BraTS2024-BraTS-GLI-TrainingData/BraTS-GLI-02368-100/BraTS-GLI-02368-100-t2f.nii.gz,../../DataSet/BraTS2024-BraTS-GLI-TrainingData/BraTS-GLI-02368-100/BraTS-GLI-02368-100-t1n.nii.gz,../../DataSet/BraTS2024-BraTS-GLI-TrainingData/BraTS-GLI-02368-100/BraTS-GLI-02368-100-seg.nii.gz,127,70,75,110,146,50,96,50,103,36,46,53
02999-100,../../DataSet/BraTS2024-BraTS-GLI-TrainingData/BraTS-GLI-02999-100/BraTS-GLI-02999-100-t1c.nii.gz,../../DataSet/BraTS2024-BraTS-GLI-TrainingData/BraTS-GLI-02999-100/BraTS-GLI-02999-100-t2w.nii.gz,../../DataSet/BraTS2024-BraTS-GLI-TrainingData/BraTS-GLI-02999-100/BraTS-GLI-02999-100-t2f.nii.gz,../../DataSet/BraTS2024-BraTS-GLI-TrainingData/BraTS-GLI-02999-100/BraTS-GLI-02999-100-t1n.nii.gz,../../DataSet/BraTS2024-BraTS-GLI-TrainingData/BraTS-GLI-02999-100/BraTS-GLI-02999-100-seg.nii.gz,114,77,112,94,136,44,115,77,141,42,71,64
02948-100,../../DataSet/BraTS2024-BraTS-GLI-TrainingData/BraTS-GLI-02948-100/BraTS-GLI-02948-100-t1c.nii.gz,../../DataSet/BraTS2024-BraTS-GLI-TrainingData/BraTS-GLI-02948-100/BraTS-GLI-02948-100-t2w.nii.gz,../../DataSet/BraTS2024-BraTS-GLI-TrainingData/BraTS-GLI-02948-100/BraTS-GLI-02948-100-t2f.nii.gz,../../DataSet/BraTS2024-BraTS-GLI-TrainingData/BraTS-GLI-02948-100/BraTS-GLI-02948-100-t1n.nii.gz,../../DataSet/BraTS2024-BraTS-GLI-TrainingData/BraTS-GLI-02948-100/BraTS-GLI-02948-100-seg.nii.gz,101,139,125,91,117,114,173,106,150,26,59,44
02992-101,../../DataSet/BraTS2024-BraTS-GLI-TrainingData/BraTS-GLI-02992-101/BraTS-GLI-02992-101-t1c.nii.gz,../../DataSet/BraTS2024-BraTS-GLI-TrainingData/BraTS-GLI-02992-101/BraTS-GLI-02992-101-t2w.nii.gz,../../DataSet/BraTS2024-BraTS-GLI-TrainingData/BraTS-GLI-02992-101/BraTS-GLI-02992-101-t2f.nii.gz,../../DataSet/BraTS2024-BraTS-GLI-TrainingData/BraTS-GLI-02992-101/BraTS-GLI-02992-101-t1n.nii.gz,../../DataSet/BraTS2024-BraTS-GLI-TrainingData/BraTS-GLI-02992-101/BraTS-GLI-02992-101-seg.nii.gz,74,101,129,60,94,77,133,111,156,34,56,45
02247-101,../../DataSet/BraTS2024-BraTS-GLI-TrainingData/BraTS-GLI-02247-101/BraTS-GLI-02247-101-t1c.nii.gz,../../DataSet/BraTS2024-BraTS-GLI-TrainingData/BraTS-GLI-02247-101/BraTS-GLI-02247-101-t2w.nii.gz,../../DataSet/BraTS2024-BraTS-GLI-TrainingData/BraTS-GLI-02247-101/BraTS-GLI-02247-101-t2f.nii.gz,../../DataSet/BraTS2024-BraTS-GLI-TrainingData/BraTS-GLI-02247-101/BraTS-GLI-02247-101-t1n.nii.gz,../../DataSet/BraTS2024-BraTS-GLI-TrainingData/BraTS-GLI-02247-101/BraTS-GLI-02247-101-seg.nii.gz,46,120,108,32,65,97,147,78,141,33,50,63
02181-101,../../DataSet/BraTS2024-BraTS-GLI-TrainingData/BraTS-GLI-02181-101/BraTS-GLI-02181-101-t1c.nii.gz,../../DataSet/BraTS2024-BraTS-GLI-TrainingData/BraTS-GLI-02181-101/BraTS-GLI-02181-101-t2w.nii.gz,../../DataSet/BraTS2024-BraTS-GLI-TrainingData/BraTS-GLI-02181-101/BraTS-GLI-02181-101-t2f.nii.gz,../../DataSet/BraTS2024-BraTS-GLI-TrainingData/BraTS-GLI-02181-101/BraTS-GLI-02181-101-t1n.nii.gz,../../DataSet/BraTS2024-BraTS-GLI-TrainingData/BraTS-GLI-02181-101/BraTS-GLI-02181-101-seg.nii.gz,127,131,93,106,153,84,175,52,129,47,91,77
02775-100,../../DataSet/BraTS2024-BraTS-GLI-TrainingData/BraTS-GLI-02775-100/BraTS-GLI-02775-100-t1c.nii.gz,../../DataSet/BraTS2024-BraTS-GLI-TrainingData/BraTS-GLI-02775-100/BraTS-GLI-02775-100-t2w.nii.gz,../../DataSet/BraTS2024-BraTS-GLI-TrainingData/BraTS-GLI-02775-100/BraTS-GLI-02775-100-t2f.nii.gz,../../DataSet/BraTS2024-BraTS-GLI-TrainingData/BraTS-GLI-02775-100/BraTS-GLI-02775-100-t1n.nii.gz,../../DataSet/BraTS2024-BraTS-GLI-TrainingData/BraTS-GLI-02775-100/BraTS-GLI-02775-100-seg.nii.gz,129,112,72,104,152,73,144,51,94,48,71,43
02314-100,../../DataSet/BraTS2024-BraTS-GLI-TrainingData/BraTS-GLI-02314-100/BraTS-GLI-02314-100-t1c.nii.gz,../../DataSet/BraTS2024-BraTS-GLI-TrainingData/BraTS-GLI-02314-100/BraTS-GLI-02314-100-t2w.nii.gz,../../DataSet/BraTS2024-BraTS-GLI-TrainingData/BraTS-GLI-02314-100/BraTS-GLI-02314-100-t2f.nii.gz,../../DataSet/BraTS2024-BraTS-GLI-TrainingData/BraTS-GLI-02314-100/BraTS-GLI-02314-100-t1n.nii.gz,../../DataSet/BraTS2024-BraTS-GLI-TrainingData/BraTS-GLI-02314-100/BraTS-GLI-02314-100-seg.nii.gz,55,130,71,35,79,106,154,48,98,44,48,50
02608-104,../../DataSet/BraTS2024-BraTS-GLI-TrainingData/BraTS-GLI-02608-104/BraTS-GLI-02608-104-t1c.nii.gz,../../DataSet/BraTS2024-BraTS-GLI-TrainingData/BraTS-GLI-02608-104/BraTS-GLI-02608-104-t2w.nii.gz,../../DataSet/BraTS2024-BraTS-GLI-TrainingData/BraTS-GLI-02608-104/BraTS-GLI-02608-104-t2f.nii.gz,../../DataSet/BraTS2024-BraTS-GLI-TrainingData/BraTS-GLI-02608-104/BraTS-GLI-02608-104-t1n.nii.gz,../../DataSet/BraTS2024-BraTS-GLI-TrainingData/BraTS-GLI-02608-104/BraTS-GLI-02608-104-seg.nii.gz,112,62,101,68,146,30,100,65,136,78,70,71
02779-101,../../DataSet/BraTS2024-BraTS-GLI-TrainingData/BraTS-GLI-02779-101/BraTS-GLI-02779-101-t1c.nii.gz,../../DataSet/BraTS2024-BraTS-GLI-TrainingData/BraTS-GLI-02779-101/BraTS-GLI-02779-101-t2w.nii.gz,../../DataSet/BraTS2024-BraTS-GLI-TrainingData/BraTS-GLI-02779-101/BraTS-GLI-02779-101-t2f.nii.gz,../../DataSet/BraTS2024-BraTS-GLI-TrainingData/BraTS-GLI-02779-101/BraTS-GLI-02779-101-t1n.nii.gz,../../DataSet/BraTS2024-BraTS-GLI-TrainingData/BraTS-GLI-02779-101/BraTS-GLI-02779-101-seg.nii.gz,74,122,132,57,105,100,148,110,153,48,48,43
02164-102,../../DataSet/BraTS2024-BraTS-GLI-TrainingData/BraTS-GLI-02164-102/BraTS-GLI-02164-102-t1c.nii.gz,../../DataSet/BraTS2024-BraTS-GLI-TrainingData/BraTS-GLI-02164-102/BraTS-GLI-02164-102-t2w.nii.gz,../../DataSet/BraTS2024-BraTS-GLI-TrainingData/BraTS-GLI-02164-102/BraTS-GLI-02164-102-t2f.nii.gz,../../DataSet/BraTS2024-BraTS-GLI-TrainingData/BraTS-GLI-02164-102/BraTS-GLI-02164-102-t1n.nii.gz,../../DataSet/BraTS2024-BraTS-GLI-TrainingData/BraTS-GLI-02164-102/BraTS-GLI-02164-102-seg.nii.gz,127,80,115,102,150,52,129,83,141,48,77,58
02240-101,../../DataSet/BraTS2024-BraTS-GLI-TrainingData/BraTS-GLI-02240-101/BraTS-GLI-02240-101-t1c.nii.gz,../../DataSet/BraTS2024-BraTS-GLI-TrainingData/BraTS-GLI-02240-101/BraTS-GLI-02240-101-t2w.nii.gz,../../DataSet/BraTS2024-BraTS-GLI-TrainingData/BraTS-GLI-02240-101/BraTS-GLI-02240-101-t2f.nii.gz,../../DataSet/BraTS2024-BraTS-GLI-TrainingData/BraTS-GLI-02240-101/BraTS-GLI-02240-101-t1n.nii.gz,../../DataSet/BraTS2024-BraTS-GLI-TrainingData/BraTS-GLI-02240-101/BraTS-GLI-02240-101-seg.nii.gz,96,163,81,62,122,133,197,52,110,60,64,58
02995-101,../../DataSet/BraTS2024-BraTS-GLI-TrainingData/BraTS-GLI-02995-101/BraTS-GLI-02995-101-t1c.nii.gz,../../DataSet/BraTS2024-BraTS-GLI-TrainingData/BraTS-GLI-02995-101/BraTS-GLI-02995-101-t2w.nii.gz,../../DataSet/BraTS2024-BraTS-GLI-TrainingData/BraTS-GLI-02995-101/BraTS-GLI-02995-101-t2f.nii.gz,../../DataSet/BraTS2024-BraTS-GLI-TrainingData/BraTS-GLI-02995-101/BraTS-GLI-02995-101-t1n.nii.gz,../../DataSet/BraTS2024-BraTS-GLI-TrainingData/BraTS-GLI-02995-101/BraTS-GLI-02995-101-seg.nii.gz,99,104,124,52,131,62,157,86,159,79,95,73
02186-101,../../DataSet/BraTS2024-BraTS-GLI-TrainingData/BraTS-GLI-02186-101/BraTS-GLI-02186-101-t1c.nii.gz,../../DataSet/BraTS2024-BraTS-GLI-TrainingData/BraTS-GLI-02186-101/BraTS-GLI-02186-101-t2w.nii.gz,../../DataSet/BraTS2024-BraTS-GLI-TrainingData/BraTS-GLI-02186-101/BraTS-GLI-02186-101-t2f.nii.gz,../../DataSet/BraTS2024-BraTS-GLI-TrainingData/BraTS-GLI-02186-101/BraTS-GLI-02186-101-t1n.nii.gz,../../DataSet/BraTS2024-BraTS-GLI-TrainingData/BraTS-GLI-02186-101/BraTS-GLI-02186-101-seg.nii.gz,116,110,113,76,140,62,151,74,146,64,89,72
00027-100,../../DataSet/BraTS2024-BraTS-GLI-TrainingData/BraTS-GLI-00027-100/BraTS-GLI-00027-100-t1c.nii.gz,../../DataSet/BraTS2024-BraTS-GLI-TrainingData/BraTS-GLI-00027-100/BraTS-GLI-00027-100-t2w.nii.gz,../../DataSet/BraTS2024-BraTS-GLI-TrainingData/BraTS-GLI-00027-100/BraTS-GLI-00027-100-t2f.nii.gz,../../DataSet/BraTS2024-BraTS-GLI-TrainingData/BraTS-GLI-00027-100/BraTS-GLI-00027-100-t1n.nii.gz,../../DataSet/BraTS2024-BraTS-GLI-TrainingData/BraTS-GLI-00027-100/BraTS-GLI-00027-100-seg.nii.gz,111,56,91,89,138,26,108,57,116,49,82,59
02772-100,../../DataSet/BraTS2024-BraTS-GLI-TrainingData/BraTS-GLI-02772-100/BraTS-GLI-02772-100-t1c.nii.gz,../../DataSet/BraTS2024-BraTS-GLI-TrainingData/BraTS-GLI-02772-100/BraTS-GLI-02772-100-t2w.nii.gz,../../DataSet/BraTS2024-BraTS-GLI-TrainingData/BraTS-GLI-02772-100/BraTS-GLI-02772-100-t2f.nii.gz,../../DataSet/BraTS2024-BraTS-GLI-TrainingData/BraTS-GLI-02772-100/BraTS-GLI-02772-100-t1n.nii.gz,../../DataSet/BraTS2024-BraTS-GLI-TrainingData/BraTS-GLI-02772-100/BraTS-GLI-02772-100-seg.nii.gz,132,61,84,109,156,35,84,57,116,47,49,59
02860-101,../../DataSet/BraTS2024-BraTS-GLI-TrainingData/BraTS-GLI-02860-101/BraTS-GLI-02860-101-t1c.nii.gz,../../DataSet/BraTS2024-BraTS-GLI-TrainingData/BraTS-GLI-02860-101/BraTS-GLI-02860-101-t2w.nii.gz,../../DataSet/BraTS2024-BraTS-GLI-TrainingData/BraTS-GLI-02860-101/BraTS-GLI-02860-101-t2f.nii.gz,../../DataSet/BraTS2024-BraTS-GLI-TrainingData/BraTS-GLI-02860-101/BraTS-GLI-02860-101-t1n.nii.gz,../../DataSet/BraTS2024-BraTS-GLI-TrainingData/BraTS-GLI-02860-101/BraTS-GLI-02860-101-seg.nii.gz,64,140,97,45,84,115,168,74,121,39,53,47
02237-100,../../DataSet/BraTS2024-BraTS-GLI-TrainingData/BraTS-GLI-02237-100/BraTS-GLI-02237-100-t1c.nii.gz,../../DataSet/BraTS2024-BraTS-GLI-TrainingData/BraTS-GLI-02237-100/BraTS-GLI-02237-100-t2w.nii.gz,../../DataSet/BraTS2024-BraTS-GLI-TrainingData/BraTS-GLI-02237-100/BraTS-GLI-02237-100-t2f.nii.gz,../../DataSet/BraTS2024-BraTS-GLI-TrainingData/BraTS-GLI-02237-100/BraTS-GLI-02237-100-t1n.nii.gz,../../DataSet/BraTS2024-BraTS-GLI-TrainingData/BraTS-GLI-02237-100/BraTS-GLI-02237-100-seg.nii.gz,76,151,113,47,121,113,188,79,145,74,75,66
02933-100,../../DataSet/BraTS2024-BraTS-GLI-TrainingData/BraTS-GLI-02933-100/BraTS-GLI-02933-100-t1c.nii.gz,../../DataSet/BraTS2024-BraTS-GLI-TrainingData/BraTS-GLI-02933-100/BraTS-GLI-02933-100-t2w.nii.gz,../../DataSet/BraTS2024-BraTS-GLI-TrainingData/BraTS-GLI-02933-100/BraTS-GLI-02933-100-t2f.nii.gz,../../DataSet/BraTS2024-BraTS-GLI-TrainingData/BraTS-GLI-02933-100/BraTS-GLI-02933-100-t1n.nii.gz,../../DataSet/BraTS2024-BraTS-GLI-TrainingData/BraTS-GLI-02933-100/BraTS-GLI-02933-100-seg.nii.gz,74,156,101,46,120,118,186,70,134,74,68,64
02120-100,../../DataSet/BraTS2024-BraTS-GLI-TrainingData/BraTS-GLI-02120-100/BraTS-GLI-02120-100-t1c.nii.gz,../../DataSet/BraTS2024-BraTS-GLI-TrainingData/BraTS-GLI-02120-100/BraTS-GLI-02120-100-t2w.nii.gz,../../DataSet/BraTS2024-BraTS-GLI-TrainingData/BraTS-GLI-02120-100/BraTS-GLI-02120-100-t2f.nii.gz,../../DataSet/BraTS2024-BraTS-GLI-TrainingData/BraTS-GLI-02120-100/BraTS-GLI-02120-100-t1n.nii.gz,../../DataSet/BraTS2024-BraTS-GLI-TrainingData/BraTS-GLI-02120-100/BraTS-GLI-02120-100-seg.nii.gz,69,141,114,45,87,97,182,74,150,42,85,76
02204-103,../../DataSet/BraTS2024-BraTS-GLI-TrainingData/BraTS-GLI-02204-103/BraTS-GLI-02204-103-t1c.nii.gz,../../DataSet/BraTS2024-BraTS-GLI-TrainingData/BraTS-GLI-02204-103/BraTS-GLI-02204-103-t2w.nii.gz,../../DataSet/BraTS2024-BraTS-GLI-TrainingData/BraTS-GLI-02204-103/BraTS-GLI-02204-103-t2f.nii.gz,../../DataSet/BraTS2024-BraTS-GLI-TrainingData/BraTS-GLI-02204-103/BraTS-GLI-02204-103-t1n.nii.gz,../../DataSet/BraTS2024-BraTS-GLI-TrainingData/BraTS-GLI-02204-103/BraTS-GLI-02204-103-seg.nii.gz,69,131,68,48,96,105,160,49,89,48,55,40
02938-101,../../DataSet/BraTS2024-BraTS-GLI-TrainingData/BraTS-GLI-02938-101/BraTS-GLI-02938-101-t1c.nii.gz,../../DataSet/BraTS2024-BraTS-GLI-TrainingData/BraTS-GLI-02938-101/BraTS-GLI-02938-101-t2w.nii.gz,../../DataSet/BraTS2024-BraTS-GLI-TrainingData/BraTS-GLI-02938-101/BraTS-GLI-02938-101-t2f.nii.gz,../../DataSet/BraTS2024-BraTS-GLI-TrainingData/BraTS-GLI-02938-101/BraTS-GLI-02938-101-t1n.nii.gz,../../DataSet/BraTS2024-BraTS-GLI-TrainingData/BraTS-GLI-02938-101/BraTS-GLI-02938-101-seg.nii.gz,118,161,91,90,150,127,191,59,133,60,64,74
